Year,Player,Pos,Age,Tm,G,GS,MP,FG,FGA,FG%,3P,3PA,3P%,2P,2PA,2P%,eFG%,FT,FTA,FT%,ORB,DRB,TRB,AST,STL,BLK,TOV,PF,PTS
2016,Quincy Acy,PF,25,SAC,59,29,876,119,214,.556,19,49,.388,100,165,.606,.600,50,68,.735,65,123,188,27,29,24,27,103,307
2016,Jordan Adams,SG,21,MEM,2,0,15,2,6,.333,0,1,.000,2,5,.400,.333,3,5,.600,0,2,2,3,3,0,2,2,7
2016,Steven Adams,C,22,OKC,80,80,2014,261,426,.613,0,0,,261,426,.613,.613,114,196,.582,219,314,533,62,42,89,84,223,636
2016,Arron Afflalo,SG,30,NYK,71,57,2371,354,799,.443,91,238,.382,263,561,.469,.500,110,131,.840,23,243,266,144,25,10,82,142,909
2016,Alexis Ajinça,C,27,NOP,59,17,861,150,315,.476,0,1,.000,150,314,.478,.476,52,62,.839,75,194,269,31,19,36,54,134,352
2016,Cole Aldrich,C,27,LAC,60,5,800,134,225,.596,0,0,,134,225,.596,.596,60,84,.714,86,202,288,50,47,68,64,139,328
2016,LaMarcus Aldridge,PF,30,SAS,74,74,2261,536,1045,.513,0,16,.000,536,1029,.521,.513,259,302,.858,176,456,632,110,38,81,99,151,1331
2016,Cliff Alexander,PF,20,POR,8,0,36,5,10,.500,0,0,,5,10,.500,.500,0,0,,2,4,6,0,1,2,1,1,10
2016,Lavoy Allen,PF,26,IND,79,28,1599,191,370,.516,0,0,,191,370,.516,.516,46,73,.630,162,262,424,76,26,42,69,147,428
2016,Tony Allen,SG,34,MEM,64,57,1620,215,469,.458,15,42,.357,200,427,.468,.474,90,138,.652,104,192,296,70,110,18,78,175,535
2016,Al-Farouq Aminu,SF,25,POR,82,82,2341,299,719,.416,126,349,.361,173,370,.468,.503,115,156,.737,98,401,499,138,72,53,120,171,839
2016,Lou Amundson,PF,33,NYK,29,0,204,19,53,.358,0,0,,19,53,.358,.358,14,27,.519,23,26,49,12,6,7,15,44,52
2016,Chris Andersen,C,37,TOT,27,15,402,38,72,.528,4,14,.286,34,58,.586,.556,25,36,.694,36,62,98,12,15,13,9,29,105
2016,Alan Anderson,SG,33,WAS,13,0,192,21,59,.356,12,37,.324,9,22,.409,.458,11,15,.733,1,26,27,14,4,1,2,25,65
2016,James Anderson,SG,26,SAC,51,15,721,67,178,.376,23,86,.267,44,92,.478,.441,22,29,.759,13,73,86,41,21,14,42,54,179
2016,Justin Anderson,SF,22,DAL,55,9,647,71,175,.406,22,83,.265,49,92,.533,.469,44,55,.800,18,114,132,29,19,25,24,45,208
2016,Kyle Anderson,SF,22,SAS,78,11,1245,138,295,.468,12,37,.324,126,258,.488,.488,62,83,.747,25,219,244,123,60,29,59,97,350
2016,Ryan Anderson,PF,27,NOP,66,7,2008,397,929,.427,131,358,.366,266,571,.466,.498,199,228,.873,131,265,396,73,38,25,90,109,1124
2016,Giannis Antetokounmpo,PG,21,MIL,80,79,2823,513,1013,.506,28,109,.257,485,904,.537,.520,296,409,.724,113,499,612,345,94,113,208,258,1350
2016,Thanasis Antetokounmpo,SF,23,NYK,2,0,6,3,4,.750,0,1,.000,3,3,1.000,.750,0,0,,0,1,1,0,0,0,0,2,6
2016,Carmelo Anthony,SF,31,NYK,72,72,2530,567,1307,.434,105,310,.339,462,997,.463,.474,334,403,.829,98,458,556,299,62,38,176,180,1573
2016,Joel Anthony,C,33,DET,19,0,96,6,10,.600,0,0,,6,10,.600,.600,6,8,.750,8,13,21,1,2,12,2,15,18
2016,Keith Appling,PG,23,ORL,5,0,27,2,8,.250,0,3,.000,2,5,.400,.250,2,2,1.000,0,1,1,1,1,0,3,5,6
2016,Trevor Ariza,SF,30,HOU,81,81,2859,357,859,.416,185,499,.371,172,360,.478,.523,126,161,.783,67,299,366,188,160,26,113,177,1025
2016,Darrell Arthur,PF,27,DEN,70,16,1516,221,489,.452,45,117,.385,176,372,.473,.498,40,53,.755,86,207,293,96,53,48,66,185,527
2016,Ömer Aşık,C,29,NOP,68,64,1178,104,195,.533,0,0,,104,195,.533,.533,61,112,.545,120,294,414,26,21,23,60,124,269
2016,D.J. Augustin,PG,28,TOT,62,0,1178,148,350,.423,68,168,.405,80,182,.440,.520,103,128,.805,8,87,95,198,38,4,84,85,467
2016,Jeff Ayres,C,28,LAC,17,0,107,12,23,.522,0,1,.000,12,22,.545,.522,6,6,1.000,4,18,22,5,0,3,6,18,30
2016,Luke Babbitt,SF,26,NOP,47,13,845,122,289,.422,44,109,.404,78,180,.433,.498,39,50,.780,25,123,148,53,11,7,23,90,327
2016,Cameron Bairstow,C,25,CHI,18,2,103,13,40,.325,1,5,.200,12,35,.343,.338,7,8,.875,4,24,28,6,2,3,4,19,34
2016,Leandro Barbosa,SG,33,GSW,68,0,1079,171,370,.462,39,110,.355,132,260,.508,.515,52,62,.839,28,89,117,82,44,10,53,107,433
2016,J.J. Barea,PG,31,DAL,74,16,1667,317,711,.446,100,260,.385,217,451,.481,.516,74,96,.771,26,126,152,302,26,2,113,110,808
2016,Andrea Bargnani,C,30,BRK,46,0,634,127,279,.455,3,16,.188,124,263,.471,.461,47,57,.825,28,69,97,18,4,9,26,61,304
2016,Harrison Barnes,SF,23,GSW,66,59,2042,295,633,.466,82,214,.383,213,419,.508,.531,102,134,.761,77,248,325,117,41,10,57,136,774
2016,Matt Barnes,SF,35,MEM,76,45,2190,264,693,.381,119,370,.322,145,323,.449,.467,111,138,.804,84,336,420,163,78,57,121,234,758
2016,Will Barton,SG,25,DEN,82,1,2353,425,983,.432,112,325,.345,313,658,.476,.489,216,268,.806,59,417,476,203,71,39,139,147,1178
2016,Brandon Bass,PF,30,LAL,66,0,1342,174,317,.549,0,2,.000,174,315,.552,.549,125,148,.845,104,181,285,74,33,55,42,125,473
2016,Nicolas Batum,SF,27,CHO,70,70,2448,372,873,.426,139,399,.348,233,474,.492,.506,163,192,.849,55,373,428,403,65,43,205,114,1046
2016,Jerryd Bayless,SG,27,MIL,52,18,1505,185,437,.423,101,231,.437,84,206,.408,.539,70,90,.778,21,120,141,163,47,11,73,111,541
2016,Aron Baynes,C,29,DET,81,1,1233,194,384,.505,0,2,.000,194,382,.508,.505,126,165,.764,140,244,384,51,21,52,67,151,514
2016,Kent Bazemore,SF,26,ATL,75,68,2083,320,725,.441,109,305,.357,211,420,.502,.517,123,151,.815,28,351,379,171,98,38,138,176,872
2016,Bradley Beal,SG,22,WAS,55,35,1708,359,799,.449,105,271,.387,254,528,.481,.515,135,176,.767,41,147,188,162,54,11,112,117,958
2016,Michael Beasley,PF,27,HOU,20,0,363,107,205,.522,3,9,.333,104,196,.531,.529,38,49,.776,29,69,98,16,11,9,24,39,255
2016,Marco Belinelli,SG,29,SAC,68,7,1672,245,635,.386,91,297,.306,154,338,.456,.457,115,138,.833,10,107,117,127,37,2,80,91,696
2016,Anthony Bennett,PF,22,TOR,19,0,84,8,27,.296,3,14,.214,5,13,.385,.352,9,10,.900,6,17,23,0,5,0,4,8,28
2016,Patrick Beverley,PG,27,HOU,71,63,2041,258,594,.434,124,310,.400,134,284,.472,.539,60,88,.682,73,177,250,239,94,26,91,234,700
2016,Bismack Biyombo,C,23,TOR,82,22,1808,156,288,.542,0,1,.000,156,287,.544,.542,142,226,.628,182,473,655,29,19,133,71,225,454
2016,Nemanja Bjelica,PF,27,MIN,60,0,1075,110,235,.468,48,125,.384,62,110,.564,.570,40,55,.727,49,161,210,83,26,21,47,154,308
2016,Tarik Black,C,24,LAL,39,0,496,57,104,.548,0,0,,57,104,.548,.548,19,45,.422,44,113,157,16,14,18,22,78,133
2016,DeJuan Blair,C,26,WAS,29,0,218,28,68,.412,0,1,.000,28,67,.418,.412,5,13,.385,20,37,57,11,8,2,15,53,61
2016,Steve Blake,PG,35,DET,58,2,986,93,240,.388,52,151,.344,41,89,.461,.496,16,20,.800,9,80,89,200,24,5,81,70,254
2016,Eric Bledsoe,PG,26,PHO,31,31,1059,223,492,.453,48,129,.372,175,363,.482,.502,138,172,.802,18,107,125,190,63,19,110,75,632
2016,Bojan Bogdanović,SF,26,BRK,79,39,2115,324,749,.433,129,338,.382,195,411,.474,.519,110,132,.833,36,219,255,99,29,5,115,119,887
2016,Andrew Bogut,C,31,GSW,70,66,1451,175,279,.627,1,1,1.000,174,278,.626,.629,24,50,.480,121,371,492,162,33,114,83,221,375
2016,Matt Bonner,C,35,SAS,30,2,206,29,57,.509,15,34,.441,14,23,.609,.640,3,4,.750,3,24,27,9,6,1,3,16,76
2016,Devin Booker,SG,19,PHO,76,51,2108,367,867,.423,99,289,.343,268,578,.464,.480,215,256,.840,27,160,187,200,44,20,160,225,1048
2016,Trevor Booker,PF,28,UTA,79,2,1632,190,388,.490,12,41,.293,178,347,.513,.505,71,106,.670,166,286,452,84,59,41,81,169,463
2016,Chris Bosh,PF,31,MIA,53,53,1778,358,767,.467,81,222,.365,277,545,.508,.520,213,268,.795,48,342,390,128,36,34,78,101,1010
2016,Avery Bradley,SG,25,BOS,76,72,2536,456,1019,.447,147,407,.361,309,612,.505,.520,96,123,.780,48,172,220,158,117,19,109,164,1155
2016,Elton Brand,C,36,PHI,17,1,225,31,72,.431,0,1,.000,31,71,.437,.431,8,9,.889,9,54,63,18,9,8,11,32,70
2016,Corey Brewer,SF,29,HOU,82,12,1669,212,552,.384,61,224,.272,151,328,.460,.439,105,140,.750,42,157,199,109,84,19,78,168,590
2016,Aaron Brooks,PG,31,CHI,69,0,1108,188,469,.401,66,185,.357,122,284,.430,.471,49,64,.766,21,80,101,180,30,10,82,132,491
2016,Anthony Brown,SF,23,LAL,29,11,599,39,126,.310,20,70,.286,19,56,.339,.389,17,20,.850,9,61,70,19,14,5,15,34,115
2016,Lorenzo Brown,PG,25,PHO,8,0,61,8,25,.320,1,8,.125,7,17,.412,.340,3,4,.750,0,7,7,11,3,1,9,4,20
2016,Markel Brown,SG,24,BRK,62,6,982,127,322,.394,38,121,.314,89,201,.443,.453,71,94,.755,23,99,122,91,38,15,54,94,363
2016,Kobe Bryant,SF,37,LAL,66,66,1863,398,1113,.358,133,467,.285,265,646,.410,.417,232,281,.826,41,206,247,184,62,13,129,115,1161
2016,Chase Budinger,SF,27,TOT,66,2,929,104,239,.435,24,86,.279,80,153,.523,.485,39,56,.696,43,107,150,64,32,10,44,62,271
2016,Reggie Bullock,SF,24,DET,37,0,429,43,98,.439,22,53,.415,21,45,.467,.551,14,15,.933,14,54,68,27,10,2,8,29,122
2016,Trey Burke,PG,23,UTA,64,0,1366,262,634,.413,88,256,.344,174,378,.460,.483,67,82,.817,18,94,112,148,35,6,80,86,679
2016,Alec Burks,SG,24,UTA,31,3,797,137,334,.410,32,79,.405,105,255,.412,.458,106,141,.752,16,93,109,63,18,4,51,71,412
2016,Caron Butler,SF,35,SAC,17,1,176,25,59,.424,3,18,.167,22,41,.537,.449,10,12,.833,5,17,22,10,9,1,3,19,63
2016,Jimmy Butler,SG,26,CHI,67,67,2474,470,1035,.454,64,205,.312,406,830,.489,.485,395,475,.832,79,279,358,321,110,43,132,124,1399
2016,Rasual Butler,SF,36,SAS,46,0,432,49,104,.471,15,49,.306,34,55,.618,.543,11,16,.688,3,53,56,24,13,23,8,11,124
2016,Bruno Caboclo,SF,20,TOR,6,1,43,1,12,.083,1,7,.143,0,5,.000,.125,0,0,,1,1,2,1,2,1,4,2,3
2016,José Calderón,PG,34,NYK,72,72,2024,209,455,.459,84,203,.414,125,252,.496,.552,42,48,.875,22,207,229,298,63,7,87,135,544
2016,Kentavious Caldwell-Pope,SG,22,DET,76,76,2789,403,960,.420,114,369,.309,289,591,.489,.479,185,228,.811,70,212,282,138,110,17,105,167,1105
2016,Isaiah Canaan,SG,24,PHI,77,39,1966,260,722,.360,176,485,.363,84,237,.354,.482,150,180,.833,20,154,174,137,56,12,91,133,846
2016,Clint Capela,C,21,HOU,77,35,1471,231,397,.582,0,1,.000,231,396,.583,.582,80,211,.379,194,300,494,47,59,92,60,190,542
2016,DeMarre Carroll,SF,29,TOR,26,22,786,105,270,.389,46,118,.390,59,152,.388,.474,30,50,.600,31,91,122,27,44,6,28,63,286
2016,Vince Carter,SG,39,MEM,60,3,1005,133,343,.388,59,169,.349,74,174,.425,.474,70,84,.833,31,115,146,56,38,16,35,101,395
2016,Michael Carter-Williams,PG,24,MIL,54,37,1649,251,555,.452,15,55,.273,236,500,.472,.466,106,162,.654,48,228,276,281,80,41,153,162,623
2016,Omri Casspi,PF,27,SAC,69,21,1880,299,622,.481,112,274,.409,187,348,.537,.571,103,159,.648,58,352,410,95,56,17,94,154,813
2016,Willie Cauley-Stein,C,22,SAC,66,39,1412,191,339,.563,0,2,.000,191,337,.567,.563,81,125,.648,134,218,352,37,48,66,46,146,463
2016,Mario Chalmers,PG,29,TOT,61,7,1373,182,444,.410,46,149,.309,136,295,.461,.462,218,262,.832,24,133,157,230,88,13,110,181,628
2016,Tyson Chandler,C,33,PHO,66,60,1618,183,314,.583,0,1,.000,183,313,.585,.583,106,171,.620,175,401,576,64,36,44,93,145,472
2016,Rakeem Christmas,PF,24,IND,1,0,6,2,2,1.000,0,0,,2,2,1.000,1.000,0,0,,1,0,1,0,0,0,0,1,4
2016,Ian Clark,SG,24,GSW,66,1,578,89,202,.441,30,84,.357,59,118,.500,.515,28,34,.824,13,55,68,64,17,13,43,58,236
2016,Coty Clarke,SF,23,BOS,3,0,6,2,4,.500,2,2,1.000,0,2,.000,.750,0,0,,0,1,1,0,0,0,1,0,6
2016,Jordan Clarkson,SG,23,LAL,79,79,2552,475,1098,.433,111,320,.347,364,778,.468,.483,164,204,.804,93,220,313,192,88,7,135,168,1225
2016,Norris Cole,PG,27,NOP,45,23,1198,196,484,.405,33,102,.324,163,382,.427,.439,52,65,.800,10,141,151,167,37,5,75,102,477
2016,Darren Collison,PG,28,SAC,74,15,2219,377,776,.486,87,217,.401,290,559,.519,.542,194,226,.858,28,141,169,318,76,4,130,142,1035
2016,Nick Collison,PF,35,OKC,59,4,699,50,109,.459,0,2,.000,50,107,.467,.459,23,33,.697,68,103,171,52,15,16,50,107,123
2016,Mike Conley,PG,28,MEM,56,56,1761,294,696,.422,78,215,.363,216,481,.449,.478,191,229,.834,26,138,164,342,67,16,84,100,857
2016,Pat Connaughton,SG,23,POR,34,0,143,13,49,.265,5,21,.238,8,28,.286,.316,5,5,1.000,11,21,32,10,2,0,10,6,36
2016,Chris Copeland,PF,31,MIL,24,1,156,17,51,.333,10,36,.278,7,15,.467,.431,6,7,.857,1,9,10,11,2,0,6,17,50
2016,Bryce Cotton,PG,23,TOT,8,0,39,4,10,.400,0,3,.000,4,7,.571,.400,0,0,,0,0,0,3,3,0,5,2,8
2016,DeMarcus Cousins,C,25,SAC,65,65,2246,601,1332,.451,70,210,.333,531,1122,.473,.477,476,663,.718,158,589,747,214,101,92,249,236,1748
2016,Robert Covington,SF,25,PHI,67,49,1903,274,712,.385,170,482,.353,104,230,.452,.504,140,177,.791,65,354,419,97,105,40,143,232,858
2016,Allen Crabbe,SG,23,POR,81,8,2105,311,678,.459,112,285,.393,199,393,.506,.541,98,113,.867,27,189,216,99,63,16,64,192,832
2016,Jamal Crawford,SG,35,LAC,79,5,2126,379,939,.404,117,344,.340,262,595,.440,.466,245,271,.904,20,125,145,183,52,12,113,122,1120
2016,Jae Crowder,SF,25,BOS,73,73,2308,360,813,.443,122,363,.336,238,450,.529,.518,196,239,.820,70,303,373,135,126,35,83,198,1038
2016,Dante Cunningham,SF,28,NOP,80,46,1971,186,412,.451,55,174,.316,131,238,.550,.518,57,82,.695,57,179,236,77,42,33,41,173,484
2016,Jared Cunningham,SG,24,TOT,44,3,410,36,105,.343,12,39,.308,24,66,.364,.400,36,55,.655,3,35,38,20,14,2,21,41,120
2016,Seth Curry,PG,25,SAC,44,9,692,102,224,.455,50,111,.450,52,113,.460,.567,45,54,.833,9,51,60,67,22,3,36,41,299
2016,Stephen Curry,PG,27,GSW,79,79,2700,805,1598,.504,402,886,.454,403,712,.566,.630,363,400,.908,68,362,430,527,169,15,262,161,2375
2016,Troy Daniels,SG,24,CHO,43,0,476,89,187,.476,59,122,.484,30,65,.462,.634,5,9,.556,7,50,57,21,11,3,24,40,242
2016,Anthony Davis,C,22,NOP,61,61,2164,560,1136,.493,35,108,.324,525,1028,.511,.508,326,430,.758,130,497,627,116,78,125,121,148,1481
2016,Ed Davis,PF,26,POR,81,0,1684,206,337,.611,0,0,,206,337,.611,.611,114,204,.559,224,375,599,88,57,72,64,202,526
2016,Branden Dawson,PF,22,LAC,6,0,29,2,5,.400,0,0,,2,5,.400,.400,1,1,1.000,2,2,4,0,0,1,0,2,5
2016,Dewayne Dedmon,C,26,ORL,58,20,705,99,177,.559,0,0,,99,177,.559,.559,57,76,.750,67,161,228,13,22,46,32,109,255
2016,Bryce Dejean-Jones,SG,23,NOP,14,11,279,28,69,.406,12,32,.375,16,37,.432,.493,11,21,.524,8,40,48,15,10,2,11,17,79
2016,Sam Dekker,PF,21,HOU,3,0,6,0,0,,0,0,,0,0,,,0,0,,0,1,1,0,1,0,0,0,0
2016,Matthew Dellavedova,PG,25,CLE,76,14,1867,207,511,.405,98,239,.410,109,272,.401,.501,57,66,.864,33,129,162,337,44,9,116,178,569
2016,Luol Deng,PF,30,MIA,74,73,2394,339,745,.455,88,256,.344,251,489,.513,.514,145,192,.755,108,335,443,140,74,29,81,122,911
2016,DeMar DeRozan,SG,26,TOR,78,78,2804,614,1377,.446,47,139,.338,567,1238,.458,.463,555,653,.850,64,285,349,315,81,21,175,167,1830
2016,Boris Diaw,PF,33,SAS,76,4,1386,202,383,.527,25,69,.362,177,314,.564,.560,56,76,.737,58,175,233,176,26,21,97,102,485
2016,Gorgui Dieng,C,26,MIN,82,39,2220,308,579,.532,6,20,.300,302,559,.540,.537,205,248,.827,157,428,585,143,94,96,140,219,827
2016,Spencer Dinwiddie,PG,22,DET,12,0,159,19,54,.352,1,10,.100,18,44,.409,.361,19,33,.576,4,13,17,22,3,0,7,20,58
2016,Toney Douglas,PG,29,NOP,61,18,1262,183,445,.411,81,203,.399,102,242,.421,.502,84,99,.848,25,118,143,157,70,5,64,131,531
2016,Goran Dragić,PG,29,MIA,72,72,2363,417,875,.477,64,205,.312,353,670,.527,.513,120,165,.727,54,223,277,419,71,17,185,188,1018
2016,Andre Drummond,C,22,DET,81,81,2666,552,1060,.521,2,6,.333,550,1054,.522,.522,208,586,.355,395,803,1198,67,119,112,155,245,1314
2016,Jared Dudley,PF,30,WAS,81,41,2098,233,487,.478,100,238,.420,133,249,.534,.581,72,98,.735,54,232,286,170,75,18,80,190,638
2016,Duje Dukan,SF,24,SAC,1,0,24,2,10,.200,2,5,.400,0,5,.000,.300,0,0,,2,2,4,1,1,0,0,2,6
2016,Tim Duncan,C,39,SAS,61,60,1536,215,441,.488,0,2,.000,215,439,.490,.488,92,131,.702,115,332,447,163,47,78,90,125,522
2016,Mike Dunleavy,SF,35,CHI,31,30,703,77,188,.410,39,99,.394,38,89,.427,.513,29,37,.784,8,75,83,39,14,10,26,66,222
2016,Kevin Durant,SF,27,OKC,72,72,2578,698,1381,.505,186,481,.387,512,900,.569,.573,447,498,.898,45,544,589,361,69,85,250,137,2029
2016,Cleanthony Early,SF,24,NYK,17,2,154,12,40,.300,4,15,.267,8,25,.320,.350,3,4,.750,4,22,26,6,2,3,9,16,31
2016,Jarell Eddie,SF,24,WAS,26,0,147,20,65,.308,15,47,.319,5,18,.278,.423,8,8,1.000,2,21,23,5,5,1,1,5,63
2016,Wayne Ellington,SG,28,BRK,76,41,1615,218,561,.389,96,268,.358,122,293,.416,.474,54,63,.857,20,154,174,83,48,5,45,82,586
2016,Monta Ellis,SG,30,IND,81,81,2734,436,1021,.427,87,282,.309,349,739,.472,.470,162,206,.786,42,229,271,383,150,37,203,174,1121
2016,James Ennis III,SF,25,TOT,22,5,329,54,113,.478,26,58,.448,28,55,.509,.593,25,34,.735,21,21,42,21,16,5,19,28,159
2016,Tyler Ennis,PG,21,MIL,46,7,654,84,187,.449,13,39,.333,71,148,.480,.484,25,34,.735,13,62,75,95,25,1,46,64,206
2016,Jeremy Evans,SF,28,DAL,30,2,251,26,48,.542,4,16,.250,22,32,.688,.583,15,21,.714,11,43,54,2,6,9,7,19,71
2016,Tyreke Evans,SG,26,NOP,25,25,765,136,314,.433,33,85,.388,103,229,.450,.486,74,93,.796,20,109,129,164,32,8,73,66,379
2016,Festus Ezeli,C,26,GSW,46,13,770,125,228,.548,0,0,,125,228,.548,.548,70,132,.530,91,166,257,32,18,50,38,94,320
2016,Kenneth Faried,PF,26,DEN,67,64,1694,349,626,.558,1,2,.500,348,624,.558,.558,136,222,.613,235,346,581,79,32,60,91,169,835
2016,Jordan Farmar,PG,29,MEM,12,10,291,42,100,.420,16,45,.356,26,55,.473,.500,10,10,1.000,4,21,25,37,15,2,18,22,110
2016,Derrick Favors,PF,24,UTA,62,59,1983,418,811,.515,0,4,.000,418,807,.518,.515,180,254,.709,169,334,503,94,74,91,104,150,1016
2016,Cristiano Felício,C,23,CHI,31,4,321,40,72,.556,0,4,.000,40,68,.588,.556,25,35,.714,30,72,102,26,6,13,13,31,105
2016,Raymond Felton,PG,31,DAL,80,31,2192,277,682,.406,60,213,.282,217,469,.463,.450,149,176,.847,36,222,258,284,68,15,121,141,763
2016,Evan Fournier,SF,23,ORL,79,71,2566,429,929,.462,156,390,.400,273,539,.506,.546,199,238,.836,33,192,225,213,96,2,133,214,1213
2016,Randy Foye,SG,32,TOT,81,8,1642,169,482,.351,75,250,.300,94,232,.405,.428,61,74,.824,24,132,156,161,39,29,86,131,474
2016,Tim Frazier,PG,25,TOT,51,2,741,96,229,.419,16,48,.333,80,181,.442,.454,53,74,.716,26,84,110,162,33,2,65,73,261
2016,Jimmer Fredette,SG,26,TOT,6,0,18,2,5,.400,1,2,.500,1,3,.333,.500,4,5,.800,0,0,0,1,1,0,2,2,9
2016,Enes Freedom,C,23,OKC,82,1,1721,414,719,.576,10,21,.476,404,698,.579,.583,200,251,.797,249,415,664,33,26,33,115,166,1038
2016,Channing Frye,PF-C,32,TOT,70,32,1200,152,347,.438,91,235,.387,61,112,.545,.569,30,35,.857,35,199,234,71,29,28,43,127,425
2016,Danilo Gallinari,SF,27,DEN,53,53,1839,287,700,.410,87,239,.364,200,461,.434,.472,375,432,.868,52,229,281,135,42,19,77,87,1036
2016,Langston Galloway,PG,24,NYK,82,7,2033,231,588,.393,77,224,.344,154,364,.423,.458,86,114,.754,43,245,288,207,77,22,61,177,625
2016,Kevin Garnett,PF,39,MIN,38,38,556,54,115,.470,0,1,.000,54,114,.474,.470,14,21,.667,15,135,150,62,28,10,16,70,122
2016,Marc Gasol,C,31,MEM,52,52,1791,328,707,.464,2,3,.667,326,704,.463,.465,203,245,.829,58,304,362,196,50,70,118,141,861
2016,Pau Gasol,C,35,CHI,72,72,2291,467,995,.469,24,69,.348,443,926,.478,.481,229,289,.792,155,638,793,294,42,146,164,148,1187
2016,Rudy Gay,SF,29,SAC,70,70,2379,466,1007,.463,74,215,.344,392,792,.495,.500,198,254,.780,103,353,456,120,100,51,139,184,1204
2016,Alonzo Gee,SF,28,NOP,73,38,1632,132,255,.518,17,60,.283,115,195,.590,.551,44,66,.667,60,185,245,72,63,13,55,169,325
2016,Paul George,SF,25,IND,81,81,2819,605,1449,.418,210,566,.371,395,883,.447,.490,454,528,.860,79,484,563,329,152,29,265,230,1874
2016,Taj Gibson,PF,30,CHI,73,55,1936,263,500,.526,0,3,.000,263,497,.529,.526,101,146,.692,206,298,504,106,47,77,78,180,627
2016,Manu Ginóbili,SG,38,SAS,58,0,1134,197,435,.453,70,179,.391,127,256,.496,.533,91,112,.813,26,120,146,177,66,11,99,99,555
2016,Rudy Gobert,C,23,UTA,61,60,1932,198,354,.559,0,0,,198,354,.559,.559,161,283,.569,208,460,668,91,45,135,114,163,557
2016,Drew Gooden,PF,34,WAS,30,0,305,33,103,.320,7,41,.171,26,62,.419,.354,9,14,.643,28,57,85,13,8,11,13,40,82
2016,Archie Goodwin,PG,21,PHO,57,13,1114,176,422,.417,23,99,.232,153,323,.474,.444,130,193,.674,27,115,142,118,27,13,100,84,505
2016,Aaron Gordon,PF,20,ORL,78,37,1863,274,579,.473,42,142,.296,232,437,.531,.509,129,193,.668,154,353,507,128,59,55,66,153,719
2016,Eric Gordon,SG,27,NOP,45,44,1481,231,552,.418,113,294,.384,118,258,.457,.521,111,125,.888,10,89,99,121,43,14,73,98,686
2016,Marcin Gortat,C,31,WAS,75,74,2256,433,764,.567,0,1,.000,433,763,.567,.567,146,207,.705,222,519,741,106,47,96,121,193,1012
2016,Andrew Goudelock,PG,27,HOU,8,0,50,9,20,.450,1,9,.111,8,11,.727,.475,3,4,.750,1,1,2,4,6,2,7,4,22
2016,Jerami Grant,PF,21,PHI,77,52,2066,251,599,.419,35,146,.240,216,453,.477,.448,212,322,.658,99,262,361,135,54,127,110,215,749
2016,Jerian Grant,PG,23,NYK,76,6,1265,154,391,.394,22,100,.220,132,291,.454,.422,96,123,.780,23,120,143,177,50,10,87,97,426
2016,Danny Green,SG,28,SAS,79,79,2062,211,561,.376,116,349,.332,95,212,.448,.480,34,46,.739,48,255,303,141,79,64,75,141,572
2016,Draymond Green,PF,25,GSW,81,81,2808,401,819,.490,100,258,.388,301,561,.537,.551,229,329,.696,134,635,769,598,119,113,259,240,1131
2016,Erick Green,PG,24,TOT,9,0,42,5,13,.385,1,5,.200,4,8,.500,.423,2,2,1.000,3,3,6,3,1,0,0,4,13
2016,Gerald Green,SG,30,MIA,69,14,1557,230,587,.392,84,260,.323,146,327,.446,.463,72,92,.783,25,138,163,56,38,19,46,123,616
2016,JaMychal Green,PF,25,MEM,78,15,1446,230,495,.465,15,45,.333,215,450,.478,.480,103,137,.752,139,234,373,67,46,33,83,189,578
2016,Jeff Green,SF,29,TOT,80,41,2253,354,824,.430,67,213,.315,287,611,.470,.470,164,220,.745,74,258,332,138,58,40,93,164,939
2016,Blake Griffin,PF,26,LAC,35,35,1170,301,603,.499,6,18,.333,295,585,.504,.504,141,194,.727,51,243,294,170,28,17,83,95,749
2016,Jorge Gutiérrez,PG,27,CHO,12,0,63,6,11,.545,0,2,.000,6,9,.667,.545,10,11,.909,0,7,7,17,3,0,6,3,22
2016,P.J. Hairston,SF,23,TOT,66,52,1313,145,408,.355,70,241,.290,75,167,.449,.441,50,64,.781,25,149,174,38,32,11,41,137,410
2016,Jordan Hamilton,SF,25,NOP,11,4,304,49,116,.422,13,45,.289,36,71,.507,.478,14,21,.667,12,50,62,25,8,3,17,24,125
2016,Tyler Hansbrough,PF,30,CHO,44,0,343,32,71,.451,2,3,.667,30,68,.441,.465,38,65,.585,40,49,89,8,12,7,12,55,104
2016,Tim Hardaway Jr.,SG,23,ATL,51,1,864,114,265,.430,48,142,.338,66,123,.537,.521,50,56,.893,7,79,86,51,21,7,23,48,326
2016,James Harden,SG,26,HOU,82,82,3125,710,1617,.439,236,657,.359,474,960,.494,.512,720,837,.860,63,438,501,612,139,51,374,229,2376
2016,Maurice Harkless,SF,22,POR,78,14,1457,195,411,.474,39,140,.279,156,271,.576,.522,69,111,.622,101,179,280,67,49,35,62,124,498
2016,Justin Harper,PF,26,DET,5,0,35,4,10,.400,4,9,.444,0,1,.000,.600,1,2,.500,0,1,1,0,1,0,2,3,13
2016,Montrezl Harrell,PF,22,HOU,39,1,379,58,90,.644,0,1,.000,58,89,.652,.644,24,46,.522,25,40,65,17,11,11,17,48,140
2016,Devin Harris,PG,32,DAL,64,0,1280,167,374,.447,52,158,.329,115,216,.532,.516,101,140,.721,18,120,138,118,60,13,66,124,487
2016,Gary Harris,SG,21,DEN,76,76,2439,359,765,.469,105,297,.354,254,468,.543,.538,109,133,.820,54,166,220,147,97,18,98,143,932
2016,Joe Harris,SG,24,CLE,5,0,15,1,4,.250,1,4,.250,0,0,,.375,0,0,,0,3,3,2,0,0,1,1,3
2016,Tobias Harris,PF,23,TOT,76,74,2513,417,889,.469,80,239,.335,337,650,.518,.514,202,243,.831,96,414,510,169,65,40,108,153,1116
2016,Aaron Harrison,SG,21,CHO,21,0,93,5,19,.263,3,10,.300,2,9,.222,.342,5,12,.417,4,11,15,2,6,0,4,10,18
2016,Udonis Haslem,PF,35,MIA,37,0,260,23,61,.377,1,9,.111,22,52,.423,.385,12,16,.750,10,65,75,14,5,2,5,25,59
2016,Spencer Hawes,PF,27,CHO,57,6,1035,124,306,.405,38,102,.373,86,204,.422,.467,54,65,.831,51,193,244,109,22,27,58,111,340
2016,Chuck Hayes,C,32,HOU,2,0,24,1,2,.500,0,0,,1,2,.500,.500,2,2,1.000,0,8,8,2,0,0,3,6,4
2016,Gordon Hayward,SF,25,UTA,80,80,2893,521,1202,.433,143,410,.349,378,792,.477,.493,393,477,.824,61,336,397,296,95,27,202,183,1578
2016,Gerald Henderson,SG,28,POR,72,0,1431,232,529,.439,48,136,.353,184,393,.468,.484,112,146,.767,30,181,211,75,39,19,68,87,624
2016,John Henson,C,25,MIL,57,1,960,164,291,.564,0,1,.000,164,290,.566,.564,69,117,.590,87,134,221,54,18,109,64,131,397
2016,Mario Hezonja,SF,20,ORL,79,9,1413,181,418,.433,67,192,.349,114,226,.504,.513,49,54,.907,28,148,176,109,39,17,97,124,478
2016,Roy Hibbert,C,29,LAL,81,81,1878,182,411,.443,0,2,.000,182,409,.445,.443,117,145,.807,132,266,398,95,32,110,76,252,481
2016,J.J. Hickson,C,27,TOT,35,9,436,80,155,.516,0,1,.000,80,154,.519,.516,46,103,.447,39,93,132,23,15,14,25,47,206
2016,Nenê,PF,33,WAS,57,11,1094,209,384,.544,0,3,.000,209,381,.549,.544,107,185,.578,52,207,259,97,54,26,76,156,525
2016,George Hill,PG,29,IND,74,73,2524,326,739,.441,128,314,.408,198,425,.466,.528,114,150,.760,58,240,298,259,83,17,101,149,894
2016,Jordan Hill,C,28,IND,73,11,1513,278,549,.506,0,1,.000,278,548,.507,.506,89,125,.712,156,295,451,87,36,37,92,155,645
2016,Solomon Hill,SF,24,IND,59,3,866,93,208,.447,24,74,.324,69,134,.515,.505,36,42,.857,39,127,166,57,37,11,33,68,246
2016,Darrun Hilliard,SG,22,DET,38,2,383,52,131,.397,19,50,.380,33,81,.407,.469,29,40,.725,5,40,45,27,9,1,19,28,152
2016,Kirk Hinrich,PG,35,TOT,46,7,631,49,129,.380,24,62,.387,25,67,.373,.473,15,16,.938,8,62,70,73,15,2,30,64,137
2016,Jrue Holiday,PG,25,NOP,65,23,1831,410,935,.439,87,259,.336,323,676,.478,.485,182,216,.843,27,168,195,391,88,22,167,148,1089
2016,Justin Holiday,SG,26,TOT,53,5,773,88,228,.386,36,105,.343,52,123,.423,.465,27,37,.730,12,78,90,56,32,19,39,61,239
2016,Ryan Hollins,C,31,TOT,37,12,460,49,79,.620,0,0,,49,79,.620,.620,26,42,.619,47,51,98,10,6,21,24,62,124
2016,Rondae Hollis-Jefferson,SF,21,BRK,29,17,615,63,138,.457,4,14,.286,59,124,.476,.471,37,52,.712,39,115,154,43,39,16,26,61,167
2016,Richaun Holmes,PF,22,PHI,51,1,702,114,222,.514,8,44,.182,106,178,.596,.532,51,74,.689,62,73,135,33,19,40,32,92,287
2016,Rodney Hood,SG,23,UTA,79,79,2541,408,972,.420,161,449,.359,247,523,.472,.503,172,200,.860,38,229,267,213,73,16,125,202,1149
2016,Al Horford,C,29,ATL,82,82,2631,529,1048,.505,88,256,.344,441,792,.557,.547,103,129,.798,148,448,596,263,68,121,107,163,1249
2016,Dwight Howard,C,30,HOU,71,71,2280,372,600,.620,0,6,.000,372,594,.626,.620,232,474,.489,238,597,835,98,69,113,166,219,976
2016,Marcelo Huertas,PG,32,LAL,53,0,869,97,230,.422,16,61,.262,81,169,.479,.457,27,29,.931,18,72,90,182,26,7,80,76,237
2016,Josh Huestis,PF,24,OKC,5,0,55,5,12,.417,4,6,.667,1,6,.167,.583,0,4,.000,2,8,10,0,1,2,3,3,14
2016,Kris Humphries,PF,30,TOT,53,17,835,121,295,.410,34,108,.315,87,187,.465,.468,67,84,.798,57,161,218,36,16,23,38,94,343
2016,R.J. Hunter,SG,22,BOS,36,0,315,36,98,.367,19,63,.302,17,35,.486,.464,6,7,.857,2,35,37,13,14,4,11,29,97
2016,Serge Ibaka,PF,26,OKC,78,78,2500,416,869,.479,60,184,.326,356,685,.520,.513,91,121,.752,141,392,533,66,38,148,108,211,983
2016,Andre Iguodala,SF,32,GSW,65,1,1732,176,368,.478,54,154,.351,122,214,.570,.552,51,83,.614,52,211,263,219,73,19,79,102,457
2016,Ersan İlyasova,PF,28,TOT,74,56,1881,280,661,.424,96,259,.371,184,402,.458,.496,111,154,.721,144,259,403,67,52,33,71,171,767
2016,Joe Ingles,SF,28,UTA,81,2,1241,124,291,.426,81,210,.386,43,81,.531,.565,13,18,.722,19,132,151,96,55,4,65,98,342
2016,Damien Inglis,SF,20,MIL,20,1,156,13,37,.351,3,13,.231,10,24,.417,.392,7,8,.875,2,29,31,10,6,3,11,11,36
2016,Kyrie Irving,PG,23,CLE,53,53,1667,394,879,.448,84,262,.321,310,617,.502,.496,169,191,.885,44,113,157,249,56,18,124,107,1041
2016,Jarrett Jack,PG,32,BRK,32,32,1027,140,358,.391,31,102,.304,109,256,.426,.434,100,112,.893,9,127,136,236,34,7,94,77,411
2016,Reggie Jackson,PG,25,DET,79,79,2424,540,1244,.434,118,334,.353,422,910,.464,.482,291,337,.864,58,195,253,492,59,11,223,187,1489
2016,LeBron James,SF,31,CLE,76,76,2709,737,1416,.520,87,282,.309,650,1134,.573,.551,359,491,.731,111,454,565,514,104,49,249,143,1920
2016,Al Jefferson,C,31,CHO,47,18,1096,245,505,.485,0,0,,245,505,.485,.485,72,111,.649,57,244,301,70,30,41,34,117,562
2016,Cory Jefferson,PF,25,PHO,8,0,50,9,22,.409,0,1,.000,9,21,.429,.409,4,6,.667,6,10,16,0,0,1,0,8,22
2016,Richard Jefferson,SF,35,CLE,74,5,1326,143,312,.458,66,173,.382,77,139,.554,.564,58,87,.667,15,113,128,59,33,14,43,129,410
2016,John Jenkins,SG,24,TOT,43,3,480,71,160,.444,16,51,.314,55,109,.505,.494,20,24,.833,8,49,57,35,8,1,27,22,178
2016,Brandon Jennings,PG,26,TOT,48,7,868,112,304,.368,51,155,.329,61,149,.409,.452,57,78,.731,16,80,96,170,29,7,57,57,332
2016,Jonas Jerebko,PF,28,BOS,78,0,1176,118,286,.413,43,108,.398,75,178,.421,.488,61,78,.782,77,211,288,62,20,24,52,137,340
2016,Amir Johnson,PF,28,BOS,79,76,1800,249,426,.585,10,43,.233,239,383,.624,.596,69,121,.570,178,327,505,138,52,83,94,214,577
2016,Chris Johnson,SF,25,UTA,70,2,857,72,194,.371,27,99,.273,45,95,.474,.441,34,42,.810,27,105,132,45,32,20,40,100,205
2016,James Johnson,PF,28,TOR,57,32,926,114,240,.475,20,66,.303,94,174,.540,.517,39,68,.574,28,98,126,67,29,33,54,84,287
2016,Joe Johnson,SF,34,TOT,81,81,2703,377,859,.439,120,313,.383,257,546,.471,.509,118,142,.831,49,243,292,318,61,4,159,146,992
2016,Orlando Johnson,SG,26,TOT,7,1,101,9,34,.265,2,10,.200,7,24,.292,.294,6,8,.750,4,11,15,2,3,3,4,9,26
2016,Stanley Johnson,SF,19,DET,73,6,1687,225,600,.375,63,205,.307,162,395,.410,.428,80,102,.784,58,248,306,118,55,12,114,178,593
2016,Tyler Johnson,SG,23,MIA,36,5,863,118,243,.486,27,71,.380,91,172,.529,.541,51,64,.797,28,81,109,79,24,14,47,66,314
2016,Wesley Johnson,SF,28,LAC,80,9,1666,208,515,.404,103,309,.333,105,206,.510,.504,30,46,.652,37,211,248,49,89,56,54,173,549
2016,Nikola Jokić,C,20,DEN,80,55,1733,307,600,.512,28,84,.333,279,516,.541,.535,154,190,.811,181,379,560,189,79,50,104,208,796
2016,Dahntay Jones,SF,35,CLE,1,0,42,6,14,.429,1,2,.500,5,12,.417,.464,0,0,,1,4,5,2,1,2,0,6,13
2016,James Jones,SF,35,CLE,48,0,463,58,142,.408,41,104,.394,17,38,.447,.553,21,26,.808,8,42,50,14,11,10,13,50,178
2016,Terrence Jones,PF,24,HOU,50,11,1044,166,367,.452,25,79,.316,141,288,.490,.486,77,116,.664,62,149,211,41,23,39,49,86,434
2016,Tyus Jones,PG,19,MIN,37,0,573,56,156,.359,16,53,.302,40,103,.388,.410,28,39,.718,7,40,47,108,31,3,33,33,156
2016,DeAndre Jordan,C,27,LAC,77,77,2598,357,508,.703,0,1,.000,357,507,.704,.703,266,619,.430,267,792,1059,90,51,177,107,207,980
2016,Cory Joseph,SG,24,TOR,80,4,2046,257,585,.439,30,110,.273,227,475,.478,.465,133,174,.764,39,171,210,250,63,20,102,131,677
2016,Chris Kaman,C,33,POR,16,2,112,20,43,.465,1,4,.250,19,39,.487,.477,3,3,1.000,7,17,24,11,1,1,8,15,44
2016,Frank Kaminsky,C,22,CHO,81,3,1708,215,525,.410,68,202,.337,147,323,.455,.474,108,148,.730,69,266,335,98,38,43,58,126,606
2016,Sergey Karasev,SF,22,BRK,40,5,399,30,74,.405,11,37,.297,19,37,.514,.480,26,28,.929,8,50,58,35,6,2,22,27,97
2016,Sasha Kaun,C,30,CLE,25,0,95,9,17,.529,0,0,,9,17,.529,.529,5,11,.455,12,14,26,3,4,5,7,11,23
2016,Ryan Kelly,PF,24,LAL,36,0,470,55,149,.369,5,37,.135,50,112,.446,.386,37,54,.685,21,100,121,20,13,10,18,39,152
2016,Michael Kidd-Gilchrist,SF,22,CHO,7,7,205,33,61,.541,3,7,.429,30,54,.556,.566,20,29,.690,12,33,45,9,3,3,8,9,89
2016,Sean Kilpatrick,SG,26,TOT,31,0,616,123,270,.456,39,114,.342,84,156,.538,.528,60,67,.896,12,44,56,29,12,2,31,37,345
2016,Brandon Knight,SG,24,PHO,52,50,1870,371,895,.415,120,351,.342,251,544,.461,.482,156,183,.852,36,166,202,263,61,20,177,124,1018
2016,Kyle Korver,SG,34,ATL,80,80,2401,268,616,.435,158,397,.398,110,219,.502,.563,45,54,.833,14,246,260,164,60,35,98,161,739
2016,Kosta Koufos,C,26,SAC,78,14,1482,236,444,.532,0,0,,236,444,.532,.532,57,104,.548,169,254,423,33,40,70,48,185,529
2016,Jeremy Lamb,SG,23,CHO,66,0,1227,230,510,.451,56,181,.309,174,329,.529,.506,64,88,.727,44,208,252,77,42,30,50,105,580
2016,Carl Landry,PF,32,PHI,36,12,569,139,250,.556,6,13,.462,133,237,.561,.568,67,91,.736,49,97,146,32,12,9,22,69,351
2016,Shane Larkin,PG,23,BRK,78,17,1751,222,502,.442,39,108,.361,183,394,.464,.481,83,107,.776,28,152,180,342,95,12,146,121,566
2016,Joffrey Lauvergne,C,24,DEN,59,15,1041,195,380,.513,13,53,.245,182,327,.557,.530,62,69,.899,77,213,290,56,13,15,54,115,465
2016,Zach LaVine,SG,20,MIN,82,33,2294,433,959,.452,123,316,.389,310,643,.482,.516,161,203,.793,27,201,228,251,69,17,155,193,1150
2016,Ty Lawson,PG,28,TOT,66,13,1411,139,354,.393,36,108,.333,103,246,.419,.444,59,86,.686,26,94,120,237,53,7,95,87,373
2016,Courtney Lee,SG,30,TOT,79,65,2334,290,639,.454,82,217,.378,208,422,.493,.518,99,118,.839,29,176,205,136,85,28,72,134,761
2016,David Lee,PF,32,TOT,55,5,903,178,335,.531,0,1,.000,178,334,.533,.531,71,93,.763,101,204,305,84,22,28,66,114,427
2016,Alex Len,C,22,PHO,78,46,1821,264,624,.423,1,7,.143,263,617,.426,.424,174,239,.728,178,416,594,97,38,62,145,230,703
2016,Kawhi Leonard,SF,24,SAS,72,72,2380,551,1090,.506,129,291,.443,422,799,.528,.565,292,334,.874,95,398,493,186,128,71,105,133,1523
2016,Meyers Leonard,PF,23,POR,61,10,1333,195,435,.448,86,228,.377,109,207,.527,.547,35,46,.761,51,263,314,92,8,18,77,183,511
2016,Jon Leuer,PF,26,PHO,67,27,1255,224,466,.481,42,110,.382,182,356,.511,.526,77,101,.762,76,297,373,72,38,30,75,125,567
2016,Damian Lillard,PG,25,POR,75,75,2676,618,1474,.419,229,610,.375,389,864,.450,.497,414,464,.892,45,257,302,512,65,28,242,165,1879
2016,Jeremy Lin,SG,27,CHO,78,13,2048,300,728,.412,76,226,.336,224,502,.446,.464,238,292,.815,42,211,253,235,58,42,150,165,914
2016,Shaun Livingston,PG,30,GSW,78,3,1520,203,379,.536,2,12,.167,201,367,.548,.538,80,93,.860,42,127,169,237,57,27,78,140,488
2016,Kevon Looney,PF,19,GSW,5,0,21,4,7,.571,1,2,.500,3,5,.600,.643,0,0,,4,6,10,0,0,0,1,2,9
2016,Brook Lopez,C,27,BRK,73,73,2457,591,1157,.511,2,14,.143,589,1143,.515,.512,317,403,.787,204,369,573,147,58,124,175,215,1501
2016,Robin Lopez,C,27,NYK,82,82,2219,357,662,.539,0,1,.000,357,661,.540,.539,128,161,.795,268,334,602,114,16,129,133,182,842
2016,Kevin Love,PF,27,CLE,77,77,2424,409,977,.419,158,439,.360,251,538,.467,.499,258,314,.822,149,613,762,186,58,41,142,159,1234
2016,Kyle Lowry,PG,29,TOR,77,77,2851,512,1198,.427,212,547,.388,300,651,.461,.516,398,491,.811,55,310,365,494,158,34,225,211,1634
2016,Trey Lyles,PF,20,UTA,80,33,1382,191,436,.438,49,128,.383,142,308,.461,.494,57,82,.695,59,240,299,59,26,18,65,114,488
2016,Shelvin Mack,PG,25,TOT,52,27,1058,182,415,.439,39,125,.312,143,290,.493,.486,45,61,.738,13,115,128,187,34,3,95,72,448
2016,Ian Mahinmi,C,29,IND,71,71,1816,264,448,.589,0,0,,264,448,.589,.589,132,225,.587,138,369,507,104,65,75,100,220,660
2016,Devyn Marble,SG,23,ORL,28,0,249,21,71,.296,8,32,.250,13,39,.333,.352,10,24,.417,6,32,38,12,13,1,7,25,60
2016,Boban Marjanović,C,27,SAS,54,4,508,105,174,.603,0,0,,105,174,.603,.603,87,114,.763,73,121,194,21,12,23,29,54,297
2016,Kendall Marshall,PG,24,PHI,30,6,400,43,118,.364,16,49,.327,27,69,.391,.432,9,13,.692,2,26,28,73,16,2,43,30,111
2016,Jarell Martin,PF,21,MEM,27,0,380,54,116,.466,0,2,.000,54,114,.474,.466,45,62,.726,39,47,86,15,8,7,19,58,153
2016,Kevin Martin,SG,32,TOT,55,13,1095,156,419,.372,49,136,.360,107,283,.378,.431,153,172,.890,14,96,110,58,26,3,54,83,514
2016,Wesley Matthews,SF,29,DAL,78,78,2644,331,854,.388,189,525,.360,142,329,.432,.498,126,146,.863,27,211,238,151,78,17,78,179,977
2016,O.J. Mayo,SG,28,MIL,41,24,1090,119,321,.371,52,162,.321,67,159,.421,.452,31,40,.775,13,92,105,118,48,8,72,126,321
2016,Luc Mbah a Moute,PF,29,LAC,75,61,1274,94,207,.454,13,40,.325,81,167,.485,.486,30,57,.526,60,111,171,30,44,19,34,100,231
2016,James Michael McAdoo,PF,23,GSW,41,1,262,45,84,.536,1,2,.500,44,82,.537,.542,26,49,.531,30,28,58,17,10,8,16,39,117
2016,Ray McCallum,PG,24,TOT,41,6,475,55,146,.377,15,42,.357,40,104,.385,.428,12,15,.800,8,39,47,60,12,7,24,29,137
2016,CJ McCollum,SG,24,POR,80,80,2780,641,1431,.448,197,472,.417,444,959,.463,.517,187,226,.827,47,212,259,341,97,23,196,187,1666
2016,T.J. McConnell,PG,23,PHI,81,17,1606,218,464,.470,31,89,.348,187,375,.499,.503,26,41,.634,43,207,250,367,95,10,140,114,493
2016,Chris McCullough,PF,20,BRK,24,4,362,44,109,.404,13,34,.382,31,75,.413,.463,11,23,.478,25,43,68,9,28,12,15,39,112
2016,K.J. McDaniels,SF,22,HOU,37,1,235,29,72,.403,7,25,.280,22,47,.468,.451,24,30,.800,16,26,42,10,7,6,17,30,89
2016,Doug McDermott,SF,24,CHI,81,4,1861,291,644,.452,110,259,.425,181,385,.470,.537,72,84,.857,37,158,195,59,14,6,53,127,764
2016,Mitch McGary,PF,23,OKC,20,0,72,11,23,.478,0,4,.000,11,19,.579,.478,4,10,.400,4,14,18,3,1,2,7,10,26
2016,JaVale McGee,C,28,DAL,34,2,370,77,134,.575,0,1,.000,77,133,.579,.575,18,36,.500,53,80,133,3,5,26,21,49,172
2016,Ben McLemore,SG,22,SAC,68,53,1443,195,455,.429,67,185,.362,128,270,.474,.502,74,103,.718,34,114,148,79,52,10,99,140,531
2016,Jordan McRae,PG,24,TOT,22,1,195,34,78,.436,10,22,.455,24,56,.429,.500,21,28,.750,4,16,20,25,3,1,15,17,99
2016,Josh McRoberts,PF,28,MIA,42,1,595,55,148,.372,12,49,.245,43,99,.434,.412,28,40,.700,22,83,105,81,18,7,30,68,150
2016,Jodie Meeks,SG,28,DET,3,0,43,7,20,.350,4,9,.444,3,11,.273,.450,4,4,1.000,1,4,5,3,0,0,1,2,22
2016,Salah Mejri,C,29,DAL,34,6,397,49,78,.628,0,1,.000,49,77,.636,.628,27,46,.587,41,82,123,10,8,36,23,54,125
2016,Jordan Mickey,PF,21,BOS,16,0,57,8,22,.364,0,0,,8,22,.364,.364,5,10,.500,6,7,13,1,0,11,1,5,21
2016,Khris Middleton,SG,24,MIL,79,79,2852,507,1142,.444,143,361,.396,364,781,.466,.507,277,312,.888,44,258,302,331,131,19,180,204,1434
2016,C.J. Miles,SF,28,IND,64,24,1464,259,634,.409,142,387,.367,117,247,.474,.521,93,124,.750,25,150,175,63,53,29,70,142,753
2016,Andre Miller,PG,39,TOT,39,4,461,59,106,.557,2,8,.250,57,98,.582,.566,24,32,.750,12,39,51,87,16,0,37,46,144
2016,Mike Miller,SF,35,DEN,47,2,373,22,62,.355,19,52,.365,3,10,.300,.508,0,0,,6,47,53,40,13,4,17,53,63
2016,Patty Mills,PG,27,SAS,81,3,1662,260,612,.425,123,320,.384,137,292,.469,.525,47,58,.810,27,131,158,226,59,6,76,102,690
2016,Elijah Millsap,SG,28,UTA,20,0,173,11,39,.282,1,12,.083,10,27,.370,.295,13,18,.722,6,29,35,19,7,3,9,33,36
2016,Paul Millsap,PF,30,ATL,81,81,2647,501,1066,.470,74,232,.319,427,834,.512,.505,309,408,.757,198,534,732,265,147,139,191,237,1385
2016,Nikola Mirotić,PF,24,CHI,66,38,1646,248,609,.407,135,346,.390,113,263,.430,.518,146,181,.807,58,304,362,100,58,46,102,151,777
2016,Nazr Mohammed,C,38,OKC,5,0,19,3,5,.600,0,0,,3,5,.600,.600,2,2,1.000,1,3,4,0,0,0,3,4,8
2016,Greg Monroe,C,25,MIL,79,67,2314,491,941,.522,0,1,.000,491,940,.522,.522,228,308,.740,218,478,696,178,72,67,129,163,1210
2016,Luis Montero,SG,22,POR,12,0,42,5,19,.263,1,9,.111,4,10,.400,.289,3,4,.750,0,4,4,1,0,0,4,1,14
2016,E'Twaun Moore,SG,26,CHI,59,22,1263,187,389,.481,47,104,.452,140,285,.491,.541,22,35,.629,19,114,133,99,37,18,53,103,443
2016,Eric Moreland,PF,24,SAC,8,0,48,3,6,.500,0,0,,3,6,.500,.500,2,4,.500,3,8,11,1,0,4,3,4,8
2016,Marcus Morris,SF,26,DET,80,80,2856,410,945,.434,108,298,.362,302,647,.467,.491,203,271,.749,91,313,404,201,67,23,140,170,1131
2016,Markieff Morris,PF,26,TOT,64,45,1629,305,718,.425,47,155,.303,258,563,.458,.458,108,147,.735,73,279,352,124,58,34,135,184,765
2016,Anthony Morrow,SG,30,OKC,68,6,926,136,333,.408,79,204,.387,57,129,.442,.527,29,39,.744,10,52,62,24,22,5,17,64,380
2016,Donatas Motiejūnas,PF,25,HOU,37,22,547,90,205,.439,16,57,.281,74,148,.500,.478,34,53,.642,37,72,109,41,17,5,44,69,230
2016,Timofey Mozgov,C,29,CLE,76,48,1326,203,359,.565,1,7,.143,202,352,.574,.567,68,95,.716,110,227,337,33,22,57,71,159,475
2016,Emmanuel Mudiay,PG,19,DEN,68,66,2068,329,905,.364,74,232,.319,255,673,.379,.404,140,209,.670,32,200,232,372,65,35,217,141,872
2016,Shabazz Muhammad,SF,23,MIN,82,0,1682,317,681,.465,44,152,.289,273,529,.516,.498,185,242,.764,100,167,267,52,24,7,70,94,863
2016,Xavier Munford,SG,23,MEM,14,0,244,32,77,.416,9,23,.391,23,54,.426,.474,7,14,.500,3,28,31,22,13,3,15,25,80
2016,Mike Muscala,C,24,ATL,60,0,565,76,152,.500,12,39,.308,64,113,.566,.539,31,39,.795,38,79,117,34,13,27,27,72,195
2016,Larry Nance Jr.,PF,23,LAL,63,22,1266,158,300,.527,1,10,.100,157,290,.541,.528,32,47,.681,101,211,312,44,54,23,41,124,349
2016,Shabazz Napier,PG,24,ORL,55,0,600,68,201,.338,34,104,.327,34,97,.351,.423,33,45,.733,9,46,55,97,23,1,46,38,203
2016,Gary Neal,SG,31,WAS,40,2,807,151,325,.465,41,100,.410,110,225,.489,.528,47,55,.855,11,72,83,47,20,1,29,55,390
2016,Jameer Nelson,PG,33,DEN,39,15,1036,113,307,.368,43,144,.299,70,163,.429,.438,30,35,.857,19,96,115,190,25,5,66,100,299
2016,Raul Neto,PG,23,UTA,81,53,1499,180,418,.431,64,162,.395,116,256,.453,.507,52,70,.743,17,103,120,174,62,2,109,122,476
2016,Andrew Nicholson,PF,26,ORL,56,0,823,146,310,.471,41,114,.360,105,196,.536,.537,51,65,.785,34,167,201,25,10,22,41,69,384
2016,Joakim Noah,C,30,CHI,29,2,635,51,133,.383,0,1,.000,51,132,.386,.383,22,45,.489,87,168,255,110,18,29,52,77,124
2016,Nerlens Noel,C,21,PHI,67,62,1965,306,587,.521,1,2,.500,305,585,.521,.522,134,227,.590,154,388,542,122,118,100,158,192,747
2016,Lucas Nogueira,C,23,TOR,29,1,225,28,44,.636,1,3,.333,27,41,.659,.648,8,15,.533,18,28,46,7,12,12,11,29,65
2016,Steve Novak,PF,32,TOT,10,0,44,8,18,.444,7,15,.467,1,3,.333,.639,1,1,1.000,0,5,5,0,0,0,1,3,24
2016,Dirk Nowitzki,PF,37,DAL,75,75,2364,498,1112,.448,126,342,.368,372,770,.483,.504,250,280,.893,52,437,489,132,52,52,84,161,1372
2016,Jusuf Nurkić,C,21,DEN,32,3,547,101,242,.417,0,3,.000,101,239,.423,.417,61,99,.616,65,110,175,40,24,44,55,91,263
2016,J.J. O'Brien,SF,23,UTA,2,0,6,0,1,.000,0,0,,0,1,.000,.000,0,0,,0,1,1,0,1,0,0,1,0
2016,Johnny O'Bryant,PF,22,MIL,66,4,857,86,209,.411,1,1,1.000,85,208,.409,.414,27,40,.675,65,111,176,32,18,8,31,100,200
2016,Kyle O'Quinn,PF,25,NYK,65,1,764,129,271,.476,5,22,.227,124,249,.498,.485,46,60,.767,76,174,250,72,20,49,61,107,309
2016,Jahlil Okafor,C,20,PHI,53,48,1591,397,781,.508,1,6,.167,396,775,.511,.509,133,194,.686,122,251,373,65,22,61,124,140,928
2016,Victor Oladipo,SG,23,ORL,72,52,2379,425,970,.438,98,282,.348,327,688,.475,.489,205,247,.830,48,297,345,282,116,54,153,174,1153
2016,Kelly Olynyk,C,24,BOS,69,8,1395,253,556,.455,85,210,.405,168,346,.486,.531,96,128,.750,72,209,281,105,52,33,74,163,687
2016,Kelly Oubre Jr.,SF,20,WAS,63,9,671,90,211,.427,25,79,.316,65,132,.492,.486,31,49,.633,25,108,133,13,22,7,34,100,236
2016,Zaza Pachulia,C,31,DAL,76,69,2004,219,470,.466,0,3,.000,219,467,.469,.466,212,276,.768,249,469,718,128,64,22,119,181,650
2016,Kostas Papanikolaou,SF,25,DEN,26,6,294,24,66,.364,10,32,.313,14,34,.412,.439,9,14,.643,8,32,40,16,13,5,21,24,67
2016,Jabari Parker,PF,20,MIL,76,72,2408,443,899,.493,9,35,.257,434,864,.502,.498,175,228,.768,123,272,395,130,69,29,116,154,1070
2016,Tony Parker,PG,33,SAS,72,72,1980,350,710,.493,27,65,.415,323,645,.501,.512,130,171,.760,17,159,176,379,54,11,131,114,857
2016,Chandler Parsons,SF,27,DAL,61,51,1799,320,651,.492,104,251,.414,216,400,.540,.571,93,136,.684,29,256,285,169,46,21,95,114,837
2016,Lamar Patterson,SG,24,ATL,35,0,395,28,80,.350,12,49,.245,16,31,.516,.425,16,22,.727,4,46,50,39,9,2,23,45,84
2016,Patrick Patterson,PF,26,TOR,79,0,2020,204,493,.414,106,293,.362,98,200,.490,.521,29,34,.853,77,265,342,94,53,32,65,128,543
2016,Chris Paul,PG,30,LAC,74,74,2420,515,1114,.462,122,329,.371,393,785,.501,.517,294,328,.896,39,271,310,738,152,13,194,185,1446
2016,Adreian Payne,PF,24,MIN,52,2,486,53,145,.366,9,32,.281,44,113,.389,.397,17,26,.654,20,91,111,29,16,11,36,77,132
2016,Cameron Payne,PG,21,OKC,57,1,698,114,278,.410,36,111,.324,78,167,.467,.475,19,24,.792,9,76,85,108,36,6,44,80,283
2016,Elfrid Payton,PG,21,ORL,73,69,2145,318,730,.436,30,92,.326,288,638,.451,.456,112,190,.589,77,184,261,468,89,20,177,159,778
2016,Nikola Peković,C,30,MIN,12,3,156,19,50,.380,0,0,,19,50,.380,.380,16,20,.800,7,14,21,11,1,0,9,22,54
2016,Kendrick Perkins,C,31,NOP,37,5,542,40,75,.533,0,0,,40,75,.533,.533,11,25,.440,25,103,128,31,11,11,41,64,91
2016,Paul Pierce,SF,38,LAC,68,38,1231,144,397,.363,75,242,.310,69,155,.445,.457,54,66,.818,12,174,186,71,33,17,58,129,417
2016,Tibor Pleiß,C,26,UTA,12,0,82,11,25,.440,0,2,.000,11,23,.478,.440,2,2,1.000,6,9,15,2,1,2,8,19,24
2016,Mason Plumlee,C,25,POR,82,82,2084,267,517,.516,0,4,.000,267,513,.520,.516,215,335,.642,201,427,628,226,68,85,154,253,749
2016,Miles Plumlee,C,27,MIL,61,14,870,140,233,.601,0,0,,140,233,.601,.601,34,59,.576,94,138,232,16,21,50,40,73,314
2016,Otto Porter Jr.,SF,22,WAS,75,73,2276,339,717,.473,98,267,.367,241,450,.536,.541,95,126,.754,97,294,391,120,105,32,70,163,871
2016,Bobby Portis,PF,20,CHI,62,4,1102,186,436,.427,16,52,.308,170,384,.443,.445,48,66,.727,123,214,337,52,25,22,54,100,436
2016,Kristaps Porziņģis,PF,20,NYK,72,72,2047,373,886,.421,81,243,.333,292,643,.454,.467,201,240,.838,132,394,526,94,53,134,121,205,1028
2016,Dwight Powell,PF,24,DAL,69,2,992,146,296,.493,2,16,.125,144,280,.514,.497,105,142,.739,84,189,273,44,36,24,40,118,399
2016,Norman Powell,SG,22,TOR,49,24,725,97,229,.424,36,89,.404,61,140,.436,.502,43,53,.811,16,95,111,47,29,10,32,59,273
2016,Phil Pressey,PG,24,TOT,23,0,283,30,78,.385,4,18,.222,26,60,.433,.410,13,25,.520,3,28,31,75,18,4,33,28,77
2016,Ronnie Price,PG,32,PHO,62,18,1211,116,302,.384,68,196,.347,48,106,.453,.497,31,41,.756,25,74,99,147,74,13,70,161,331
2016,Pablo Prigioni,PG,38,LAC,59,3,823,55,147,.374,28,95,.295,27,52,.519,.469,7,8,.875,38,76,114,130,53,1,49,82,145
2016,Tayshaun Prince,SF,35,MIN,77,44,1462,102,229,.445,4,23,.174,98,206,.476,.454,13,19,.684,32,115,147,73,36,13,27,62,221
2016,Julius Randle,PF,21,LAL,81,60,2286,358,835,.429,10,36,.278,348,799,.436,.435,193,270,.715,172,657,829,144,53,29,149,242,919
2016,Zach Randolph,PF,34,MEM,68,53,2016,431,907,.475,6,26,.231,425,881,.482,.479,172,216,.796,179,350,529,142,43,13,105,146,1040
2016,J.J. Redick,SG,31,LAC,75,75,2097,422,880,.480,200,421,.475,222,459,.484,.593,182,205,.888,10,129,139,106,42,5,78,135,1226
2016,Willie Reed,C,25,BRK,39,2,426,76,133,.571,0,0,,76,133,.571,.571,30,55,.545,49,73,122,10,6,30,16,47,182
2016,Josh Richardson,SG,22,MIA,52,2,1107,123,272,.452,53,115,.461,70,157,.446,.550,42,63,.667,21,86,107,73,36,25,35,107,341
2016,Austin Rivers,SG,23,LAC,67,7,1464,226,516,.438,62,185,.335,164,331,.495,.498,79,116,.681,22,108,130,99,48,9,61,137,593
2016,Andre Roberson,SG,24,OKC,70,70,1553,136,274,.496,32,103,.311,104,171,.608,.555,33,54,.611,79,172,251,47,53,42,35,133,337
2016,Brian Roberts,PG,30,TOT,51,0,470,74,165,.448,15,42,.357,59,123,.480,.494,42,47,.894,6,35,41,54,10,2,23,35,205
2016,Glenn Robinson III,SF,22,IND,45,4,508,65,151,.430,14,37,.378,51,114,.447,.477,27,39,.692,12,56,68,26,17,9,18,21,171
2016,Nate Robinson,PG,31,NOP,2,1,23,0,1,.000,0,1,.000,0,0,,.000,0,0,,0,0,0,4,1,0,0,5,0
2016,Thomas Robinson,PF,24,BRK,71,7,917,130,291,.447,0,1,.000,130,290,.448,.447,47,109,.431,136,223,359,46,39,36,69,111,307
2016,Rajon Rondo,PG,29,SAC,72,72,2537,355,782,.454,62,170,.365,293,612,.479,.494,87,150,.580,77,358,435,839,141,10,278,175,859
2016,Derrick Rose,PG,27,CHI,66,66,2097,447,1048,.427,44,150,.293,403,898,.449,.448,142,179,.793,46,179,225,311,44,14,175,84,1080
2016,Terrence Ross,SF,24,TOR,73,7,1747,270,626,.431,131,339,.386,139,287,.484,.536,49,62,.790,21,164,185,56,54,25,46,120,720
2016,Terry Rozier,PG,21,BOS,39,0,311,29,106,.274,6,27,.222,23,79,.291,.302,8,10,.800,24,39,63,37,6,1,19,23,72
2016,Ricky Rubio,PG,25,MIN,76,76,2323,219,586,.374,62,190,.326,157,396,.396,.427,266,314,.847,40,286,326,658,162,10,193,201,766
2016,Damjan Rudež,SF,29,MIN,33,0,277,25,62,.403,17,50,.340,8,12,.667,.540,8,8,1.000,5,15,20,11,3,1,13,33,75
2016,Brandon Rush,SG,30,GSW,72,25,1055,111,260,.427,65,157,.414,46,103,.447,.552,18,28,.643,21,160,181,57,20,23,33,57,305
2016,D'Angelo Russell,PG,19,LAL,80,48,2259,392,956,.410,130,370,.351,262,586,.447,.478,140,190,.737,47,227,274,266,93,13,196,142,1054
2016,Robert Sacre,C,26,LAL,25,1,320,31,75,.413,0,0,,31,75,.413,.413,25,38,.658,32,40,72,14,4,10,12,43,87
2016,JaKarr Sampson,SF,22,TOT,73,40,1160,140,317,.442,14,63,.222,126,254,.496,.464,80,122,.656,46,144,190,46,23,33,70,142,374
2016,Dennis Schröder,PG,22,ATL,80,6,1621,329,781,.421,77,239,.322,252,542,.465,.471,144,182,.791,25,179,204,349,70,9,183,138,879
2016,Luis Scola,PF,35,TOR,76,76,1636,269,598,.450,65,161,.404,204,437,.467,.504,61,84,.726,84,276,360,66,46,27,68,178,664
2016,Mike Scott,PF,27,ATL,75,0,1146,176,376,.468,62,158,.392,114,218,.523,.551,50,63,.794,53,153,206,78,25,17,42,102,464
2016,Thabo Sefolosha,SF,31,ATL,75,11,1758,188,372,.505,42,124,.339,146,248,.589,.562,62,99,.626,52,282,334,107,85,37,68,109,480
2016,Kevin Séraphin,C,26,NYK,48,0,526,84,205,.410,0,2,.000,84,203,.414,.410,19,23,.826,31,95,126,47,8,36,43,67,187
2016,Ramon Sessions,PG,29,WAS,82,5,1667,280,592,.473,36,111,.324,244,481,.507,.503,214,283,.756,25,178,203,239,46,5,115,102,810
2016,Iman Shumpert,SG,25,CLE,54,5,1316,114,305,.374,43,146,.295,71,159,.447,.444,40,51,.784,32,171,203,92,54,19,57,119,311
2016,Jonathon Simmons,SG,26,SAS,55,2,813,122,242,.504,18,47,.383,104,195,.533,.541,69,92,.750,16,80,96,58,24,5,53,103,331
2016,Henry Sims,C,25,BRK,14,4,263,33,77,.429,0,0,,33,77,.429,.429,25,30,.833,21,51,72,9,9,14,12,37,91
2016,Kyle Singler,SF,27,OKC,68,2,977,86,221,.389,30,97,.309,56,124,.452,.457,29,44,.659,50,91,141,24,30,9,32,120,231
2016,Donald Sloan,PG,28,BRK,61,33,1318,154,350,.440,38,99,.384,116,251,.462,.494,78,104,.750,17,156,173,268,32,4,80,73,424
2016,Marcus Smart,PG,21,BOS,61,10,1667,184,529,.348,61,241,.253,123,288,.427,.405,129,166,.777,76,179,255,185,91,18,80,183,558
2016,Greg Smith,PF,25,MIN,18,0,192,18,32,.563,0,0,,18,32,.563,.563,7,17,.412,12,30,42,6,4,1,7,28,43
2016,Ish Smith,PG,27,TOT,77,53,2239,397,967,.411,56,170,.329,341,797,.428,.440,122,176,.693,43,262,305,502,88,24,175,133,972
2016,J.R. Smith,SG,30,CLE,77,77,2362,353,850,.415,204,510,.400,149,340,.438,.535,45,71,.634,43,174,217,130,81,21,59,204,955
2016,Jason Smith,C,29,ORL,76,2,1181,244,503,.485,4,16,.250,240,487,.493,.489,54,67,.806,53,166,219,62,33,65,57,163,546
2016,Josh Smith,PF,30,TOT,55,7,880,127,349,.364,41,143,.287,86,206,.417,.423,37,67,.552,51,141,192,90,34,47,77,118,332
2016,Russ Smith,PG,24,MEM,15,0,66,7,22,.318,1,5,.200,6,17,.353,.341,8,13,.615,1,8,9,11,5,1,7,5,23
2016,Tony Snell,SF,24,CHI,64,33,1301,126,339,.372,56,155,.361,70,184,.380,.454,30,33,.909,19,180,199,63,16,17,52,100,338
2016,Marreese Speights,C,28,GSW,72,0,832,197,456,.432,24,62,.387,173,394,.439,.458,94,114,.825,77,162,239,61,19,34,66,117,512
2016,Tiago Splitter,C,31,ATL,36,2,579,81,155,.523,0,2,.000,81,153,.529,.523,39,48,.813,45,75,120,30,20,12,24,71,201
2016,Nik Stauskas,SG,22,PHI,73,35,1809,210,545,.385,106,325,.326,104,220,.473,.483,91,118,.771,23,160,183,138,44,20,94,115,617
2016,Lance Stephenson,SF,25,TOT,69,13,1372,228,474,.481,30,78,.385,198,396,.500,.513,87,111,.784,40,183,223,133,43,9,94,135,573
2016,Alex Stepheson,PF,28,TOT,8,0,73,9,27,.333,0,0,,9,27,.333,.333,4,12,.333,19,9,28,2,1,5,0,12,22
2016,Jarnell Stokes,C,22,TOT,7,0,18,3,5,.600,0,0,,3,5,.600,.600,1,2,.500,1,3,4,1,1,0,0,1,7
2016,Amar'e Stoudemire,C,33,MIA,52,36,762,125,221,.566,0,0,,125,221,.566,.566,50,67,.746,65,157,222,27,18,41,47,92,300
2016,Rodney Stuckey,PG,29,IND,58,1,1275,183,443,.413,20,83,.241,163,360,.453,.436,131,158,.829,19,137,156,142,43,8,76,77,517
2016,Jared Sullinger,PF,23,BOS,81,73,1915,351,806,.435,29,103,.282,322,703,.458,.453,103,161,.640,194,479,673,187,75,47,102,209,834
2016,Edy Tavares,C,23,ATL,11,0,73,11,19,.579,0,0,,11,19,.579,.579,3,8,.375,7,14,21,3,1,6,5,8,25
2016,Jeff Teague,PG,27,ATL,79,78,2255,434,988,.439,110,275,.400,324,713,.454,.495,261,312,.837,33,181,214,470,97,24,218,167,1239
2016,Mirza Teletović,PF,30,PHO,79,1,1686,332,777,.427,181,460,.393,151,317,.476,.544,120,155,.774,55,247,302,89,32,21,84,159,965
2016,Garrett Temple,SF,29,WAS,80,43,1951,201,505,.398,89,258,.345,112,247,.453,.486,91,125,.728,36,176,212,140,69,18,64,195,582
2016,Jason Terry,SG,38,HOU,72,7,1258,151,376,.402,93,261,.356,58,115,.504,.525,27,33,.818,14,65,79,103,47,9,49,91,422
2016,Isaiah Thomas,PG,26,BOS,82,79,2644,591,1382,.428,167,465,.359,424,917,.462,.488,474,544,.871,46,197,243,509,91,9,220,167,1823
2016,Lance Thomas,PF,27,NYK,59,5,1313,169,382,.442,44,109,.404,125,273,.458,.500,102,119,.857,34,97,131,53,22,7,57,109,484
2016,Hollis Thompson,SG,24,PHI,77,17,2154,270,680,.397,149,392,.380,121,288,.420,.507,69,96,.719,54,218,272,99,36,24,76,187,758
2016,Jason Thompson,C,29,TOT,47,7,471,52,108,.481,5,15,.333,47,93,.505,.505,38,54,.704,32,102,134,29,12,20,15,80,147
2016,Klay Thompson,SG,25,GSW,80,80,2666,651,1386,.470,276,650,.425,375,736,.510,.569,193,221,.873,35,271,306,166,60,49,138,152,1771
2016,Tristan Thompson,PF,24,CLE,82,34,2269,247,420,.588,0,0,,247,420,.588,.588,149,242,.616,268,470,738,62,38,51,61,202,643
2016,Marcus Thornton,SG,28,TOT,61,8,1109,216,542,.399,91,270,.337,125,272,.460,.482,67,79,.848,38,112,150,85,47,4,51,90,590
2016,Anthony Tolliver,PF,30,DET,72,5,1341,128,332,.386,98,272,.360,30,60,.500,.533,29,47,.617,39,190,229,52,26,16,28,86,383
2016,Axel Toupane,SF,23,DEN,21,0,305,25,70,.357,13,40,.325,12,30,.400,.450,13,17,.765,8,23,31,15,7,6,6,40,76
2016,Karl-Anthony Towns,C,20,MIN,82,82,2627,625,1153,.542,30,88,.341,595,1065,.559,.555,223,275,.811,229,629,858,161,58,138,183,245,1503
2016,P.J. Tucker,SF,30,PHO,82,80,2540,239,582,.411,68,206,.330,171,376,.455,.469,106,142,.746,165,347,512,177,106,20,111,202,652
2016,Evan Turner,SG,27,BOS,81,12,2271,343,753,.456,20,83,.241,323,670,.482,.469,148,179,.827,50,347,397,359,80,28,169,139,854
2016,Myles Turner,C,19,IND,60,30,1367,264,530,.498,3,14,.214,261,516,.506,.501,88,121,.727,68,264,332,41,25,86,67,158,619
2016,Beno Udrih,PG,33,TOT,44,5,707,86,198,.434,15,44,.341,71,154,.461,.472,18,20,.900,8,64,72,116,14,1,53,51,205
2016,Jonas Valančiūnas,C,23,TOR,60,59,1557,303,536,.565,0,0,,303,536,.565,.565,162,213,.761,184,363,547,42,25,80,85,158,768
2016,Anderson Varejão,C,33,TOT,53,0,496,53,124,.427,0,1,.000,53,123,.431,.427,32,50,.640,37,104,141,35,16,10,22,70,138
2016,Greivis Vásquez,PG,29,MIL,23,0,460,45,138,.326,18,73,.247,27,65,.415,.391,22,26,.846,5,42,47,91,10,0,40,42,130
2016,Rashad Vaughn,SG,19,MIL,70,6,1001,81,266,.305,43,147,.293,38,119,.319,.385,12,15,.800,11,77,88,39,29,16,28,73,217
2016,Charlie Villanueva,PF,31,DAL,62,4,665,125,327,.382,47,172,.273,78,155,.503,.454,22,24,.917,24,128,152,24,18,15,31,71,319
2016,Noah Vonleh,PF,20,POR,78,56,1174,117,278,.421,11,46,.239,106,232,.457,.441,38,51,.745,91,214,305,30,27,26,50,152,283
2016,Nikola Vučević,C,25,ORL,65,60,2037,533,1046,.510,2,9,.222,531,1037,.512,.511,113,150,.753,174,402,576,179,53,70,123,173,1181
2016,Sasha Vujačić,SG,31,NYK,61,25,908,106,277,.383,52,143,.364,54,134,.403,.477,32,39,.821,26,123,149,84,34,5,44,83,296
2016,Dwyane Wade,SG,34,MIA,74,73,2258,540,1183,.456,7,44,.159,533,1139,.468,.459,322,406,.793,82,220,302,344,79,42,203,116,1409
2016,Dion Waiters,SG,24,OKC,78,15,2152,282,706,.399,86,240,.358,196,466,.421,.460,112,157,.713,36,166,202,154,81,15,120,143,762
2016,Kemba Walker,PG,25,CHO,81,81,2885,568,1331,.427,182,490,.371,386,841,.459,.495,371,438,.847,56,301,357,421,126,39,171,111,1689
2016,John Wall,PG,25,WAS,77,77,2784,572,1349,.424,115,328,.351,457,1021,.448,.467,272,344,.791,42,337,379,789,145,59,318,159,1531
2016,T.J. Warren,SF,22,PHO,47,4,1070,221,441,.501,28,70,.400,193,371,.520,.533,45,64,.703,57,90,147,44,37,16,32,94,515
2016,C.J. Watson,PG,31,ORL,33,2,656,47,137,.343,14,48,.292,33,89,.371,.394,34,39,.872,10,56,66,88,19,5,25,49,142
2016,Briante Weber,PG,23,TOT,7,4,169,14,39,.359,0,5,.000,14,34,.412,.359,3,4,.750,8,17,25,21,9,3,9,12,31
2016,Sonny Weems,SG-SF,29,TOT,43,0,499,42,110,.382,15,41,.366,27,69,.391,.450,8,15,.533,7,46,53,49,10,1,41,47,107
2016,David West,PF,35,SAS,78,19,1404,244,448,.545,3,7,.429,241,441,.546,.548,63,80,.788,72,237,309,143,44,55,68,142,554
2016,Russell Westbrook,PG,27,OKC,80,80,2750,656,1444,.454,101,341,.296,555,1103,.503,.489,465,573,.812,145,481,626,834,163,20,342,200,1878
2016,Hassan Whiteside,C,26,MIA,73,43,2125,413,682,.606,0,0,,413,682,.606,.606,214,329,.650,238,627,865,30,44,269,137,201,1040
2016,Shayne Whittington,PF,24,IND,7,0,41,5,11,.455,0,2,.000,5,9,.556,.455,1,2,.500,5,7,12,3,1,1,5,7,11
2016,Andrew Wiggins,SF,20,MIN,81,81,2845,594,1294,.459,57,190,.300,537,1104,.486,.481,430,565,.761,105,186,291,164,78,46,182,165,1675
2016,C.J. Wilcox,SG,25,LAC,23,0,167,26,66,.394,9,23,.391,17,43,.395,.462,9,12,.750,1,11,12,10,10,2,2,15,70
2016,Alan Williams,PF,23,PHO,10,0,68,10,24,.417,0,0,,10,24,.417,.417,9,14,.643,14,24,38,5,4,5,6,15,29
2016,Deron Williams,PG,31,DAL,65,63,2106,321,775,.414,97,282,.344,224,493,.454,.477,179,206,.869,19,171,190,378,61,14,150,155,918
2016,Derrick Williams,SF,24,NYK,80,9,1435,254,565,.450,44,150,.293,210,415,.506,.488,194,256,.758,47,249,296,75,29,9,61,69,746
2016,Elliot Williams,PG,26,MEM,5,0,45,2,10,.200,1,4,.250,1,6,.167,.250,3,4,.750,1,3,4,4,0,0,1,2,8
2016,Lou Williams,SG,29,LAL,67,35,1907,283,693,.408,110,320,.344,173,373,.464,.488,352,424,.830,31,138,169,167,62,19,107,107,1028
2016,Marvin Williams,PF,29,CHO,81,81,2338,338,747,.452,152,378,.402,186,369,.504,.554,120,144,.833,127,394,521,110,58,77,62,133,948
2016,Mo Williams,PG,33,CLE,41,14,748,132,302,.437,36,102,.353,96,200,.480,.497,38,42,.905,6,66,72,98,14,5,57,60,338
2016,Justise Winslow,SF,19,MIA,78,8,2232,195,462,.422,32,116,.276,163,346,.471,.457,80,117,.684,81,322,403,117,68,26,95,184,502
2016,Jeff Withey,C,25,UTA,51,10,658,87,162,.537,0,2,.000,87,160,.544,.537,43,59,.729,56,117,173,20,21,53,28,75,217
2016,Christian Wood,PF,20,PHI,17,0,145,22,53,.415,4,11,.364,18,42,.429,.453,13,21,.619,13,25,38,3,5,7,2,11,61
2016,Metta World Peace,SF,36,LAL,35,5,590,55,177,.311,26,84,.310,29,93,.312,.384,40,57,.702,19,70,89,27,22,11,15,67,176
2016,Brandan Wright,PF,28,MEM,12,2,212,35,52,.673,0,0,,35,52,.673,.673,13,24,.542,14,29,43,6,5,15,10,21,83
2016,Delon Wright,PG,23,TOR,27,1,229,36,80,.450,5,13,.385,31,67,.463,.481,26,35,.743,8,29,37,31,8,3,16,7,103
2016,Tony Wroten,PG,22,PHI,8,3,144,22,65,.338,3,17,.176,19,48,.396,.362,20,37,.541,2,19,21,20,3,0,29,11,67
2016,James Young,SG,20,BOS,29,0,199,11,36,.306,6,26,.231,5,10,.500,.389,1,4,.250,4,22,26,9,6,1,5,17,29
2016,Joe Young,PG,23,IND,41,0,384,62,169,.367,10,46,.217,52,123,.423,.396,20,25,.800,6,44,50,65,15,0,33,30,154
2016,Nick Young,SG,30,LAL,54,2,1033,126,372,.339,77,237,.325,49,135,.363,.442,63,76,.829,14,83,97,34,23,7,30,50,392
2016,Thaddeus Young,PF,27,BRK,73,73,2407,495,963,.514,7,30,.233,488,933,.523,.518,105,163,.644,176,484,660,136,112,37,136,182,1102
2016,Cody Zeller,C,23,CHO,73,60,1774,231,437,.529,1,10,.100,230,427,.539,.530,175,232,.754,138,317,455,71,57,63,68,204,638
2016,Tyler Zeller,C,26,BOS,60,3,710,138,290,.476,0,0,,138,290,.476,.476,88,108,.815,62,116,178,29,10,22,46,97,364
2017,Álex Abrines,SG,23,OKC,68,6,1055,134,341,.393,94,247,.381,40,94,.426,.531,44,49,.898,18,68,86,40,37,8,33,114,406
2017,Quincy Acy,PF,26,TOT,38,1,558,70,170,.412,37,90,.411,33,80,.413,.521,45,60,.750,20,95,115,18,14,15,21,67,222
2017,Steven Adams,C,23,OKC,80,80,2389,374,655,.571,0,1,.000,374,654,.572,.571,157,257,.611,281,332,613,86,89,78,146,195,905
2017,Arron Afflalo,SG,31,SAC,61,45,1580,185,420,.440,62,151,.411,123,269,.457,.514,83,93,.892,9,116,125,78,21,6,42,104,515
2017,Alexis Ajinça,C,28,NOP,39,15,584,89,178,.500,0,4,.000,89,174,.511,.500,29,40,.725,46,131,177,12,20,22,31,77,207
2017,Cole Aldrich,C,28,MIN,62,0,531,45,86,.523,0,0,,45,86,.523,.523,15,22,.682,51,107,158,25,25,23,17,85,105
2017,LaMarcus Aldridge,PF,31,SAS,72,72,2335,500,1049,.477,23,56,.411,477,993,.480,.488,220,271,.812,172,351,523,139,46,88,98,158,1243
2017,Lavoy Allen,PF,27,IND,61,5,871,77,168,.458,0,1,.000,77,167,.461,.458,23,33,.697,105,114,219,57,18,24,29,78,177
2017,Tony Allen,SG,35,MEM,71,66,1914,274,595,.461,15,54,.278,259,541,.479,.473,80,130,.615,166,225,391,98,115,29,100,178,643
2017,Al-Farouq Aminu,PF,26,POR,61,25,1773,183,466,.393,70,212,.330,113,254,.445,.468,96,136,.706,77,374,451,99,60,44,94,102,532
2017,Chris Andersen,C,38,CLE,12,0,114,9,22,.409,0,3,.000,9,19,.474,.409,10,14,.714,9,22,31,5,5,7,5,20,28
2017,Alan Anderson,SF,34,LAC,30,0,308,30,80,.375,14,44,.318,16,36,.444,.463,12,16,.750,3,21,24,11,3,0,7,35,86
2017,Justin Anderson,SF,23,TOT,75,10,1228,186,439,.424,58,194,.299,128,245,.522,.490,102,129,.791,69,176,245,66,41,23,66,109,532
2017,Kyle Anderson,SF,23,SAS,72,14,1020,93,209,.445,15,40,.375,78,169,.462,.481,45,57,.789,33,175,208,91,51,26,39,63,246
2017,Ryan Anderson,PF,28,HOU,72,72,2116,323,773,.418,204,506,.403,119,267,.446,.550,129,150,.860,112,218,330,68,31,14,55,142,979
2017,Giannis Antetokounmpo,SF,22,MIL,80,80,2845,656,1259,.521,49,180,.272,607,1079,.563,.541,471,612,.770,142,558,700,434,131,151,234,246,1832
2017,Carmelo Anthony,SF,32,NYK,74,74,2538,602,1389,.433,151,421,.359,451,968,.466,.488,304,365,.833,62,376,438,213,60,34,153,198,1659
2017,Joel Anthony,C,34,SAS,19,0,122,10,16,.625,0,0,,10,16,.625,.625,5,8,.625,8,23,31,3,2,6,4,11,25
2017,Trevor Ariza,SF,31,HOU,80,80,2773,326,798,.409,191,555,.344,135,243,.556,.528,93,126,.738,54,404,458,175,147,20,73,133,936
2017,Darrell Arthur,PF,28,DEN,41,7,639,95,215,.442,53,117,.453,42,98,.429,.565,19,22,.864,25,87,112,42,19,21,36,76,262
2017,Ömer Aşık,C,30,NOP,31,19,482,31,65,.477,0,0,,31,65,.477,.477,23,39,.590,48,115,163,15,5,10,14,51,85
2017,D.J. Augustin,PG,29,ORL,78,20,1538,195,517,.377,95,274,.347,100,243,.412,.469,131,161,.814,15,102,117,209,31,1,90,101,616
2017,Luke Babbitt,SF,27,MIA,68,55,1065,113,281,.402,87,210,.414,26,71,.366,.557,11,15,.733,12,129,141,36,20,11,25,118,324
2017,Ron Baker,SG,23,NYK,52,13,857,82,217,.378,23,86,.267,59,131,.450,.431,28,43,.651,12,86,98,107,34,8,56,74,215
2017,Wade Baldwin,PG,20,MEM,33,1,405,36,115,.313,3,22,.136,33,93,.355,.326,31,37,.838,11,35,46,61,18,7,39,40,106
2017,Leandro Barbosa,SG,34,PHO,67,0,963,172,392,.439,35,98,.357,137,294,.466,.483,40,45,.889,15,89,104,81,31,8,48,82,419
2017,J.J. Barea,PG,32,DAL,35,6,771,142,343,.414,53,148,.358,89,195,.456,.491,44,51,.863,9,75,84,193,14,1,63,30,381
2017,Harrison Barnes,PF,24,DAL,79,79,2803,599,1280,.468,78,222,.351,521,1058,.492,.498,242,281,.861,93,301,394,116,65,15,102,128,1518
2017,Matt Barnes,SF,36,TOT,74,18,1777,185,473,.391,87,263,.331,98,210,.467,.483,70,89,.787,70,314,384,195,48,26,107,185,527
2017,Will Barton,SG,26,DEN,60,19,1705,295,666,.443,87,235,.370,208,431,.483,.508,143,190,.753,58,201,259,206,48,28,97,110,820
2017,Brandon Bass,PF,31,LAC,52,0,577,107,186,.575,1,3,.333,106,183,.579,.578,77,88,.875,43,86,129,21,14,11,29,45,292
2017,Nicolas Batum,SG,28,CHO,77,77,2617,393,975,.403,135,405,.333,258,570,.453,.472,243,284,.856,46,435,481,456,86,29,194,109,1164
2017,Jerryd Bayless,PG,28,PHI,3,1,71,11,32,.344,2,5,.400,9,27,.333,.375,9,10,.900,3,9,12,13,0,0,9,4,33
2017,Aron Baynes,C,30,DET,75,2,1163,143,279,.513,0,0,,143,279,.513,.513,79,94,.840,111,222,333,32,17,39,50,166,365
2017,Kent Bazemore,SF,27,ATL,73,64,1963,295,721,.409,92,266,.346,203,455,.446,.473,119,168,.708,45,186,231,177,91,52,125,165,801
2017,Bradley Beal,SG,23,WAS,77,77,2684,637,1322,.482,223,552,.404,414,770,.538,.566,282,342,.825,53,187,240,267,83,21,156,169,1779
2017,Malik Beasley,SG,20,DEN,22,1,165,33,73,.452,9,28,.321,24,45,.533,.514,8,10,.800,5,12,17,11,7,0,8,10,83
2017,Michael Beasley,PF,28,MIL,56,6,935,216,406,.532,18,43,.419,198,363,.545,.554,78,105,.743,40,153,193,53,27,27,66,92,528
2017,Marco Belinelli,SG,30,CHO,74,0,1778,264,615,.429,102,283,.360,162,332,.488,.512,150,168,.893,14,164,178,147,44,9,70,90,780
2017,DeAndre' Bembry,SF,22,ATL,38,1,371,47,98,.480,1,18,.056,46,80,.575,.485,6,16,.375,14,45,59,28,8,5,16,21,101
2017,Dragan Bender,PF,19,PHO,43,0,574,57,161,.354,28,101,.277,29,60,.483,.441,4,11,.364,23,80,103,23,10,22,32,74,146
2017,Anthony Bennett,PF,23,BRK,23,1,264,38,92,.413,13,48,.271,25,44,.568,.484,26,36,.722,25,53,78,12,5,3,12,18,115
2017,Ben Bentil,PF,21,DAL,3,0,10,0,3,.000,0,1,.000,0,2,.000,.000,0,0,,0,2,2,0,0,0,1,1,0
2017,Dāvis Bertāns,PF,24,SAS,67,6,808,103,234,.440,69,173,.399,34,61,.557,.588,28,34,.824,22,76,98,46,20,28,32,75,303
2017,Patrick Beverley,SG,28,HOU,67,67,2058,228,543,.420,110,288,.382,118,255,.463,.521,73,95,.768,95,298,393,281,99,25,100,222,639
2017,Bismack Biyombo,C,24,ORL,81,27,1793,179,339,.528,0,0,,179,339,.528,.528,125,234,.534,157,410,567,74,25,91,95,202,483
2017,Nemanja Bjelica,PF,28,MIN,65,1,1190,151,356,.424,56,177,.316,95,179,.531,.503,45,61,.738,57,187,244,79,40,20,59,154,403
2017,Tarik Black,C,25,LAL,67,16,1091,150,294,.510,1,2,.500,149,292,.510,.512,82,109,.752,144,199,343,39,29,44,58,173,383
2017,Eric Bledsoe,PG,27,PHO,66,66,2176,449,1034,.434,104,310,.335,345,724,.477,.485,388,458,.847,52,268,320,418,91,31,224,164,1390
2017,Bojan Bogdanović,SF,27,TOT,81,54,2083,376,845,.445,144,392,.367,232,453,.512,.530,217,243,.893,37,240,277,111,34,7,131,146,1113
2017,Andrew Bogut,C,32,TOT,27,21,583,38,81,.469,0,1,.000,38,80,.475,.469,3,11,.273,56,162,218,49,13,25,43,86,79
2017,Joel Bolomboy,PF,23,UTA,12,0,53,9,16,.563,1,4,.250,8,12,.667,.594,3,6,.500,4,13,17,2,1,2,2,1,22
2017,Devin Booker,SG,20,PHO,78,78,2730,606,1431,.423,147,405,.363,459,1026,.447,.475,367,441,.832,46,203,249,268,72,21,241,242,1726
2017,Trevor Booker,PF,29,BRK,71,43,1754,305,591,.516,25,78,.321,280,513,.546,.537,74,110,.673,143,428,571,138,75,28,127,152,709
2017,Avery Bradley,SG,26,BOS,55,55,1835,359,775,.463,108,277,.390,251,498,.504,.533,68,93,.731,65,269,334,122,68,11,88,141,894
2017,Corey Brewer,SF,30,TOT,82,11,1281,147,348,.422,27,118,.229,120,230,.522,.461,50,68,.735,32,134,166,97,61,20,55,133,371
2017,Malcolm Brogdon,SG,24,MIL,75,28,1982,290,635,.457,78,193,.404,212,442,.480,.518,109,126,.865,47,166,213,317,84,12,113,140,767
2017,Aaron Brooks,PG,32,IND,65,0,894,121,300,.403,48,128,.375,73,172,.424,.483,32,40,.800,18,51,69,125,25,9,66,93,322
2017,Anthony Brown,SF,24,TOT,11,0,159,18,50,.360,7,27,.259,11,23,.478,.430,0,0,,8,25,33,8,5,1,6,15,43
2017,Bobby Brown,PG,32,HOU,25,0,123,23,60,.383,14,35,.400,9,25,.360,.500,2,2,1.000,0,6,6,14,1,0,5,5,62
2017,Jaylen Brown,SF,20,BOS,78,20,1341,192,423,.454,46,135,.341,146,288,.507,.508,85,124,.685,45,175,220,64,35,18,68,142,515
2017,Nicolás Brussino,SG,23,DAL,54,2,521,52,141,.369,29,95,.305,23,46,.500,.472,17,22,.773,26,69,95,47,17,8,26,43,150
2017,Reggie Bullock,SF,25,DET,31,5,467,54,128,.422,28,73,.384,26,55,.473,.531,5,7,.714,13,51,64,29,18,3,10,22,141
2017,Trey Burke,PG,24,WAS,57,0,703,116,255,.455,31,70,.443,85,185,.459,.516,22,29,.759,7,40,47,100,11,5,48,54,285
2017,Alec Burks,SG,25,UTA,42,0,653,99,248,.399,25,76,.329,74,172,.430,.450,60,78,.769,17,103,120,30,18,5,35,50,283
2017,Jimmy Butler,SF,27,CHI,76,75,2809,570,1252,.455,91,248,.367,479,1004,.477,.492,585,676,.865,129,341,470,417,143,32,159,112,1816
2017,Bruno Caboclo,SF,21,TOR,9,0,40,6,16,.375,2,6,.333,4,10,.400,.438,0,0,,5,5,10,4,2,1,2,4,14
2017,José Calderón,PG,35,TOT,41,13,539,55,134,.410,20,64,.313,35,70,.500,.485,11,12,.917,15,59,74,88,11,1,41,36,141
2017,Kentavious Caldwell-Pope,SG,23,DET,76,75,2529,370,928,.399,153,437,.350,217,491,.442,.481,154,185,.832,55,193,248,193,89,12,86,118,1047
2017,Isaiah Canaan,SG,25,CHI,39,0,592,63,173,.364,25,94,.266,38,79,.481,.436,30,33,.909,6,44,50,37,22,1,21,35,181
2017,Clint Capela,C,22,HOU,65,59,1551,362,563,.643,0,0,,362,563,.643,.643,94,177,.531,178,348,526,63,34,79,87,179,818
2017,DeMarre Carroll,SF,30,TOR,72,72,1882,220,550,.400,109,320,.341,111,230,.483,.499,89,117,.761,63,212,275,74,81,27,54,143,638
2017,Vince Carter,SF,40,MEM,73,15,1799,193,490,.394,112,296,.378,81,194,.418,.508,88,115,.765,36,191,227,133,60,36,50,163,586
2017,Michael Carter-Williams,PG,25,CHI,45,19,846,112,306,.366,15,64,.234,97,242,.401,.391,58,77,.753,24,129,153,113,38,23,66,102,297
2017,Omri Casspi,PF,28,TOT,36,2,643,77,164,.470,15,43,.349,62,121,.512,.515,17,29,.586,27,85,112,37,23,3,29,50,186
2017,Willie Cauley-Stein,C,23,SAC,75,21,1421,255,481,.530,0,2,.000,255,479,.532,.530,101,151,.669,85,254,339,80,53,44,69,147,611
2017,Tyson Chandler,C,34,PHO,47,46,1298,153,228,.671,0,0,,153,228,.671,.671,91,124,.734,153,386,539,30,33,24,65,126,397
2017,Wilson Chandler,SF,29,DEN,71,33,2197,433,939,.461,110,326,.337,323,613,.527,.520,141,194,.727,103,357,460,141,51,30,114,172,1117
2017,Marquese Chriss,PF,19,PHO,82,75,1743,284,632,.449,72,224,.321,212,408,.520,.506,113,181,.624,96,252,348,60,67,70,108,263,753
2017,Rakeem Christmas,PF,25,IND,29,0,219,19,43,.442,0,0,,19,43,.442,.442,21,29,.724,26,30,56,4,3,6,8,37,59
2017,Semaj Christon,PG,24,OKC,64,1,973,77,223,.345,12,63,.190,65,160,.406,.372,17,31,.548,19,68,87,130,28,7,43,79,183
2017,Ian Clark,SG,25,GSW,77,0,1137,211,433,.487,61,163,.374,150,270,.556,.558,44,58,.759,22,99,121,90,39,8,55,77,527
2017,Jordan Clarkson,SG,24,LAL,82,19,2397,477,1071,.445,117,356,.329,360,715,.503,.500,134,168,.798,49,197,246,213,88,8,164,150,1205
2017,Norris Cole,PG,28,OKC,13,0,125,16,52,.308,3,13,.231,13,39,.333,.337,8,10,.800,0,11,11,14,8,0,7,18,43
2017,Darren Collison,PG,29,SAC,68,64,2063,340,714,.476,73,175,.417,267,539,.495,.527,147,171,.860,23,129,152,312,67,9,114,119,900
2017,Nick Collison,PF,36,OKC,20,0,128,14,23,.609,0,1,.000,14,22,.636,.609,5,8,.625,9,22,31,12,2,2,4,17,33
2017,Mike Conley,PG,29,MEM,69,68,2292,464,1009,.460,171,419,.408,293,590,.497,.545,316,368,.859,31,210,241,433,92,19,156,126,1415
2017,Pat Connaughton,SG,24,POR,39,1,316,37,72,.514,17,33,.515,20,39,.513,.632,7,9,.778,10,42,52,28,6,2,17,23,98
2017,Quinn Cook,PG,23,TOT,14,0,188,33,66,.500,11,26,.423,22,40,.550,.583,2,5,.400,1,6,7,26,4,0,13,13,79
2017,DeMarcus Cousins,C,26,TOT,72,72,2465,647,1432,.452,131,363,.361,516,1069,.483,.498,517,670,.772,152,642,794,332,100,93,269,278,1942
2017,Robert Covington,SF,26,PHI,67,67,2119,292,732,.399,137,412,.333,155,320,.484,.492,143,174,.822,92,344,436,102,127,69,131,203,864
2017,Allen Crabbe,SG,24,POR,79,7,2254,303,647,.468,134,302,.444,169,345,.490,.572,105,124,.847,19,207,226,94,54,20,62,171,845
2017,Jamal Crawford,SG,36,LAC,82,1,2157,359,870,.413,116,322,.360,243,548,.443,.479,174,203,.857,17,112,129,214,61,14,134,115,1008
2017,Jordan Crawford,SG,28,NOP,19,0,442,105,218,.482,37,95,.389,68,123,.553,.567,20,26,.769,4,30,34,57,11,2,25,30,267
2017,Jae Crowder,SF,26,BOS,72,72,2335,333,720,.463,157,394,.398,176,326,.540,.572,176,217,.811,48,367,415,155,73,23,80,161,999
2017,Dante Cunningham,PF,29,NOP,66,35,1649,174,359,.485,71,181,.392,103,178,.579,.584,16,27,.593,56,221,277,37,39,28,28,100,435
2017,Seth Curry,PG,26,DAL,70,42,2029,338,703,.481,137,322,.425,201,381,.528,.578,85,100,.850,25,154,179,189,79,7,92,126,898
2017,Stephen Curry,PG,28,GSW,79,79,2638,675,1443,.468,324,789,.411,351,654,.537,.580,325,362,.898,61,292,353,524,142,17,239,183,1999
2017,Troy Daniels,SG,25,MEM,67,3,1183,185,495,.374,138,355,.389,47,140,.336,.513,43,54,.796,22,78,100,46,20,4,45,90,551
2017,Anthony Davis,C,23,NOP,75,75,2708,770,1526,.505,40,134,.299,730,1392,.524,.518,519,647,.802,172,712,884,157,94,167,181,168,2099
2017,Deyonta Davis,C,20,MEM,36,0,238,24,47,.511,0,0,,24,47,.511,.511,10,18,.556,20,40,60,2,3,17,8,40,58
2017,Ed Davis,PF,27,POR,46,12,789,75,142,.528,0,0,,75,142,.528,.528,50,81,.617,96,148,244,26,15,22,37,137,200
2017,Dewayne Dedmon,C,27,SAS,76,37,1330,161,259,.622,0,0,,161,259,.622,.622,65,93,.699,129,367,496,44,37,61,61,180,387
2017,Sam Dekker,PF,22,HOU,77,2,1419,203,429,.473,60,187,.321,143,242,.591,.543,38,68,.559,94,190,284,76,38,21,41,83,504
2017,Malcolm Delaney,PG,27,ATL,73,2,1248,145,388,.374,26,110,.236,119,278,.428,.407,75,93,.806,10,113,123,193,39,1,95,112,391
2017,Matthew Dellavedova,PG,26,MIL,76,54,1986,208,534,.390,79,215,.367,129,319,.404,.463,82,96,.854,24,123,147,357,53,0,133,153,577
2017,Luol Deng,SF,31,LAL,56,49,1486,164,424,.387,51,165,.309,113,259,.436,.447,46,63,.730,63,232,295,74,48,20,43,61,425
2017,DeMar DeRozan,SG,27,TOR,74,74,2620,721,1545,.467,33,124,.266,688,1421,.484,.477,545,647,.842,70,316,386,290,78,13,180,134,2020
2017,Cheick Diallo,PF,20,NOP,17,0,199,36,76,.474,0,0,,36,76,.474,.474,15,21,.714,23,50,73,4,4,7,7,17,87
2017,Boris Diaw,PF,34,UTA,73,33,1283,146,327,.446,20,81,.247,126,246,.512,.477,26,35,.743,46,112,158,170,18,9,87,83,338
2017,Gorgui Dieng,PF,27,MIN,82,82,2653,332,661,.502,16,43,.372,316,618,.511,.514,136,167,.814,188,459,647,158,88,95,107,254,816
2017,Spencer Dinwiddie,PG,23,BRK,59,18,1334,134,302,.444,38,101,.376,96,201,.478,.507,126,159,.792,27,137,164,185,44,23,66,119,432
2017,Toney Douglas,PG,30,MEM,24,0,394,43,117,.368,7,42,.167,36,75,.480,.397,24,29,.828,13,48,61,56,18,5,21,50,117
2017,Goran Dragić,PG,30,MIA,73,73,2459,534,1124,.475,117,289,.405,417,835,.499,.527,298,377,.790,62,217,279,423,89,13,212,199,1483
2017,Andre Drummond,C,23,DET,81,81,2409,483,911,.530,2,7,.286,481,904,.532,.531,137,355,.386,345,770,1115,90,124,89,152,237,1105
2017,Jared Dudley,PF,31,PHO,64,7,1362,157,346,.454,77,203,.379,80,143,.559,.565,43,65,.662,31,194,225,121,42,16,73,154,434
2017,Mike Dunleavy,SF,36,TOT,53,2,841,93,220,.423,53,134,.396,40,86,.465,.543,36,45,.800,18,97,115,50,15,7,28,67,275
2017,Kris Dunn,PG,22,MIN,78,7,1333,118,313,.377,21,73,.288,97,240,.404,.411,36,59,.610,24,142,166,188,78,36,89,178,293
2017,Kevin Durant,PF,28,GSW,62,62,2070,551,1026,.537,117,312,.375,434,714,.608,.594,336,384,.875,39,474,513,300,66,99,138,117,1555
2017,Jarell Eddie,SF,25,PHO,5,0,62,6,19,.316,4,16,.250,2,3,.667,.421,8,9,.889,1,6,7,0,1,0,1,1,24
2017,Henry Ellenson,PF,20,DET,19,2,146,23,64,.359,10,35,.286,13,29,.448,.438,4,8,.500,8,33,41,7,1,1,14,6,60
2017,Wayne Ellington,SG,29,MIA,62,13,1500,231,555,.416,149,394,.378,82,161,.509,.550,37,43,.860,18,114,132,70,35,4,30,70,648
2017,Monta Ellis,SG,31,IND,74,33,1998,247,557,.443,43,135,.319,204,422,.483,.482,93,128,.727,19,185,204,236,78,27,135,149,630
2017,Joel Embiid,C,22,PHI,31,31,786,200,429,.466,36,98,.367,164,331,.495,.508,191,244,.783,61,182,243,66,27,76,117,112,627
2017,James Ennis III,SF,26,MEM,64,28,1501,146,321,.455,51,137,.372,95,184,.516,.534,86,110,.782,69,190,259,64,46,19,59,165,429
2017,Tyler Ennis,PG,22,TOT,53,2,588,90,208,.433,27,70,.386,63,138,.457,.498,21,25,.840,9,36,45,86,25,2,45,58,228
2017,Tyreke Evans,SF,27,TOT,40,6,788,150,370,.405,42,118,.356,108,252,.429,.462,69,92,.750,13,124,137,124,35,9,61,60,411
2017,Dante Exum,PG,21,UTA,66,26,1228,155,363,.427,44,149,.295,111,214,.519,.488,58,73,.795,30,102,132,111,21,12,80,146,412
2017,Kenneth Faried,PF,27,DEN,61,34,1296,228,416,.548,0,6,.000,228,410,.556,.548,131,189,.693,183,279,462,55,43,40,59,124,587
2017,Jordan Farmar,PG,30,SAC,2,0,35,4,12,.333,4,9,.444,0,3,.000,.500,0,0,,1,2,3,9,2,0,3,1,12
2017,Derrick Favors,PF,25,UTA,50,39,1186,203,417,.487,3,10,.300,200,407,.491,.490,67,109,.615,92,213,305,56,45,40,60,103,476
2017,Kay Felder,PG,21,CLE,42,0,386,62,158,.392,7,22,.318,55,136,.404,.415,35,49,.714,3,38,41,58,18,7,30,38,166
2017,Cristiano Felício,C,24,CHI,66,0,1040,128,221,.579,0,0,,128,221,.579,.579,60,93,.645,124,187,311,40,25,17,33,110,316
2017,Raymond Felton,PG,32,LAC,80,11,1700,221,514,.430,46,144,.319,175,370,.473,.475,50,64,.781,33,185,218,191,66,22,83,125,538
2017,Yogi Ferrell,PG,23,TOT,46,29,1197,160,394,.406,68,176,.386,92,218,.422,.492,74,89,.831,20,91,111,172,42,9,70,90,462
2017,Dorian Finney-Smith,PF,23,DAL,81,35,1642,124,333,.372,56,191,.293,68,142,.479,.456,46,61,.754,55,167,222,67,52,25,45,125,350
2017,Bryn Forbes,SG,23,SAS,36,0,285,36,99,.364,17,53,.321,19,46,.413,.449,5,6,.833,2,21,23,23,1,0,11,20,94
2017,Evan Fournier,SG,24,ORL,68,66,2234,408,930,.439,128,360,.356,280,570,.491,.508,223,277,.805,44,165,209,202,66,4,141,180,1167
2017,Randy Foye,SG,33,BRK,69,40,1284,118,325,.363,67,203,.330,51,122,.418,.466,54,63,.857,9,146,155,135,35,9,80,99,357
2017,Tim Frazier,PG,26,NOP,65,35,1525,163,404,.403,40,128,.313,123,276,.446,.453,98,129,.760,34,139,173,335,56,6,101,133,464
2017,Enes Freedom,C,24,OKC,72,0,1533,402,737,.545,5,38,.132,397,699,.568,.549,224,285,.786,195,287,482,67,32,38,123,154,1033
2017,Channing Frye,C,33,CLE,74,15,1398,238,520,.458,137,335,.409,101,185,.546,.589,63,74,.851,37,253,290,45,33,37,53,138,676
2017,Danilo Gallinari,SF,28,DEN,63,63,2134,335,750,.447,126,324,.389,209,426,.491,.531,349,387,.902,39,286,325,135,40,15,82,93,1145
2017,Langston Galloway,PG,25,TOT,74,2,1495,207,545,.380,120,308,.390,87,237,.367,.490,51,64,.797,27,129,156,93,46,6,46,96,585
2017,Patricio Garino,SG,23,ORL,5,0,43,0,7,.000,0,5,.000,0,2,.000,.000,0,0,,1,6,7,0,0,0,3,4,0
2017,Marc Gasol,C,32,MEM,74,74,2531,532,1160,.459,104,268,.388,428,892,.480,.503,278,332,.837,60,404,464,338,67,99,166,171,1446
2017,Pau Gasol,C,36,SAS,64,39,1627,303,604,.502,56,104,.538,247,500,.494,.548,130,184,.707,107,394,501,150,24,70,81,110,792
2017,Rudy Gay,SF,30,SAC,30,30,1013,201,442,.455,42,113,.372,159,329,.483,.502,118,138,.855,35,155,190,83,44,26,74,79,562
2017,Michael Gbinije,SG,24,DET,9,0,32,1,10,.100,0,4,.000,1,6,.167,.100,2,2,1.000,2,1,3,2,0,0,0,2,4
2017,Alonzo Gee,SF,29,DEN,13,0,89,3,14,.214,0,3,.000,3,11,.273,.214,5,9,.556,4,11,15,6,5,1,4,14,11
2017,Paul George,SF,26,IND,75,75,2689,622,1348,.461,195,496,.393,427,852,.501,.534,336,374,.898,58,434,492,251,119,27,220,206,1775
2017,Marcus Georges-Hunt,SG,22,ORL,5,0,48,2,7,.286,1,2,.500,1,5,.200,.357,9,10,.900,1,8,9,3,1,0,2,5,14
2017,Jonathan Gibson,PG,29,DAL,17,0,231,35,95,.368,15,45,.333,20,50,.400,.447,21,29,.724,1,21,22,26,8,0,21,21,106
2017,Taj Gibson,PF,31,TOT,78,71,1989,365,709,.515,3,13,.231,362,696,.520,.517,113,158,.715,158,327,485,73,41,65,105,163,846
2017,Manu Ginóbili,SG,39,SAS,69,0,1291,171,439,.390,89,227,.392,82,212,.387,.491,86,107,.804,28,129,157,183,82,16,96,119,517
2017,Rudy Gobert,C,24,UTA,81,81,2744,413,625,.661,0,1,.000,413,624,.662,.661,311,476,.653,314,721,1035,97,49,214,147,246,1137
2017,Archie Goodwin,SG,22,TOT,15,0,214,36,66,.545,5,15,.333,31,51,.608,.583,33,42,.786,7,21,28,24,4,5,14,8,110
2017,Aaron Gordon,SF,21,ORL,80,72,2298,393,865,.454,77,267,.288,316,598,.528,.499,156,217,.719,116,289,405,150,65,40,89,172,1019
2017,Eric Gordon,SG,28,HOU,75,15,2323,412,1016,.406,246,661,.372,166,355,.468,.527,147,175,.840,29,172,201,188,48,41,121,150,1217
2017,Marcin Gortat,C,32,WAS,82,82,2556,390,674,.579,0,2,.000,390,672,.580,.579,103,159,.648,238,611,849,121,40,61,119,213,883
2017,Treveon Graham,SG,23,CHO,27,1,189,19,40,.475,9,15,.600,10,25,.400,.588,10,15,.667,5,17,22,6,6,1,3,18,57
2017,Jerami Grant,PF,22,TOT,80,4,1531,152,328,.463,43,116,.371,109,212,.514,.529,90,147,.612,38,167,205,46,33,79,44,149,437
2017,Jerian Grant,PG,24,CHI,63,28,1028,128,301,.425,49,134,.366,79,167,.473,.507,65,73,.890,17,94,111,121,47,8,44,93,370
2017,Danny Green,SG,29,SAS,68,68,1807,176,449,.392,118,311,.379,58,138,.420,.523,27,32,.844,31,193,224,124,70,57,76,120,497
2017,Draymond Green,PF,26,GSW,76,76,2471,272,650,.418,81,263,.308,191,387,.494,.481,151,213,.709,98,501,599,533,154,106,184,217,776
2017,Gerald Green,SF,31,BOS,47,0,538,95,232,.409,39,111,.351,56,121,.463,.494,33,41,.805,16,68,84,33,9,7,25,48,262
2017,JaMychal Green,PF,26,MEM,77,75,2101,250,500,.500,55,145,.379,195,355,.549,.555,134,167,.802,167,377,544,84,47,34,94,248,689
2017,Jeff Green,PF,30,ORL,69,11,1534,220,558,.394,53,193,.275,167,365,.458,.442,145,168,.863,39,175,214,81,37,13,75,103,638
2017,Blake Griffin,PF,27,LAC,61,61,2076,479,971,.493,38,113,.336,441,858,.514,.513,320,421,.760,112,385,497,300,57,22,142,157,1316
2017,Justin Hamilton,C,26,BRK,64,7,1177,174,379,.459,55,180,.306,119,199,.598,.532,39,52,.750,71,191,262,55,29,43,43,91,442
2017,A.J. Hammons,C,24,DAL,22,0,163,17,42,.405,5,10,.500,12,32,.375,.464,9,20,.450,8,28,36,4,1,13,10,21,48
2017,Tim Hardaway Jr.,SG,24,ATL,79,30,2154,415,912,.455,149,417,.357,266,495,.537,.537,164,214,.766,35,189,224,182,55,15,106,103,1143
2017,James Harden,PG,27,HOU,81,81,2947,674,1533,.440,262,756,.347,412,777,.530,.525,746,881,.847,95,564,659,907,121,38,464,215,2356
2017,Maurice Harkless,SF,23,POR,77,69,2223,314,624,.503,68,194,.351,246,430,.572,.558,77,124,.621,125,216,341,88,85,70,86,214,773
2017,Justin Harper,PF,27,PHI,3,0,31,5,12,.417,2,7,.286,3,5,.600,.500,0,0,,2,3,5,2,0,0,4,2,12
2017,Montrezl Harrell,C,23,HOU,58,14,1064,225,345,.652,1,7,.143,224,338,.663,.654,76,121,.628,81,138,219,64,20,42,44,126,527
2017,Devin Harris,PG,33,DAL,65,0,1087,136,341,.399,58,177,.328,78,164,.476,.484,107,129,.829,11,116,127,136,43,7,57,101,437
2017,Gary Harris,SG,22,DEN,57,56,1782,320,637,.502,107,255,.420,213,382,.558,.586,104,134,.776,48,130,178,164,71,8,76,92,851
2017,Joe Harris,SG,25,BRK,52,11,1138,154,362,.425,85,221,.385,69,141,.489,.543,35,49,.714,16,131,147,54,30,8,55,121,428
2017,Manny Harris,SG,27,DAL,4,0,25,3,15,.200,0,2,.000,3,13,.231,.200,2,4,.500,3,6,9,2,0,0,2,1,8
2017,Tobias Harris,PF,24,DET,82,48,2567,511,1063,.481,109,314,.347,402,749,.537,.532,190,226,.841,63,353,416,142,60,39,96,133,1321
2017,Aaron Harrison,SG,22,CHO,5,0,17,0,4,.000,0,2,.000,0,2,.000,.000,1,2,.500,0,3,3,3,0,0,0,2,1
2017,Andrew Harrison,PG,22,MEM,72,18,1474,117,360,.325,43,156,.276,74,204,.363,.385,148,194,.763,23,113,136,198,53,21,85,194,425
2017,Udonis Haslem,C,36,MIA,16,0,130,11,23,.478,0,3,.000,11,20,.550,.478,9,15,.600,8,28,36,6,6,1,8,22,31
2017,Spencer Hawes,PF,28,TOT,54,1,797,134,277,.484,25,81,.309,109,196,.556,.529,44,52,.846,38,153,191,81,15,30,49,77,337
2017,Gordon Hayward,SF,26,UTA,73,73,2516,545,1156,.471,149,374,.398,396,782,.506,.536,362,429,.844,49,345,394,252,73,20,140,117,1601
2017,Gerald Henderson,SG,29,PHI,72,41,1667,234,553,.423,61,173,.353,173,380,.455,.478,133,165,.806,34,151,185,112,40,15,62,129,662
2017,John Henson,C,26,MIL,58,39,1123,159,309,.515,0,1,.000,159,308,.516,.515,74,107,.692,92,203,295,57,29,78,52,151,392
2017,Juancho Hernangómez,PF,21,DEN,62,9,842,101,224,.451,46,113,.407,55,111,.495,.554,57,76,.750,43,144,187,29,30,12,31,62,305
2017,Willy Hernangómez,C,22,NYK,72,22,1324,246,465,.529,4,15,.267,242,450,.538,.533,91,125,.728,170,332,502,96,41,36,100,150,587
2017,Mario Hezonja,SF,21,ORL,65,2,960,117,330,.355,43,144,.299,74,186,.398,.420,40,50,.800,20,126,146,62,30,15,58,74,317
2017,Roy Hibbert,C,30,TOT,48,13,682,80,147,.544,0,0,,80,147,.544,.544,61,75,.813,54,98,152,21,8,46,32,100,221
2017,Buddy Hield,SG,24,TOT,82,55,1888,327,767,.426,148,379,.391,179,388,.461,.523,64,76,.842,35,234,269,121,38,9,101,115,866
2017,Nenê,C,34,HOU,67,8,1198,245,397,.617,3,9,.333,242,388,.624,.621,116,197,.589,95,187,282,65,56,39,73,163,609
2017,George Hill,PG,30,UTA,49,49,1544,289,606,.477,94,233,.403,195,373,.523,.554,157,196,.801,23,144,167,204,50,11,85,114,829
2017,Jordan Hill,C,29,MIN,7,0,47,5,13,.385,0,0,,5,13,.385,.385,2,2,1.000,8,6,14,0,1,0,4,9,12
2017,Solomon Hill,SF,25,NOP,80,71,2374,183,478,.383,94,270,.348,89,208,.428,.481,103,128,.805,51,256,307,141,72,32,82,182,563
2017,Darrun Hilliard,SG,23,DET,39,1,381,47,126,.373,12,46,.261,35,80,.438,.421,21,28,.750,2,31,33,33,11,2,28,39,127
2017,Jrue Holiday,PG,26,NOP,67,61,2190,405,893,.454,100,281,.356,305,612,.498,.510,119,168,.708,46,218,264,488,100,44,194,133,1029
2017,Justin Holiday,SG,27,NYK,82,4,1639,233,538,.433,97,273,.355,136,265,.513,.523,66,80,.825,27,198,225,102,65,31,66,109,629
2017,Rondae Hollis-Jefferson,SF,22,BRK,78,50,1761,235,542,.434,15,67,.224,220,475,.463,.447,190,253,.751,96,356,452,154,82,44,116,177,675
2017,Richaun Holmes,C,23,PHI,57,17,1193,230,412,.558,27,77,.351,203,335,.606,.591,72,103,.699,94,217,311,58,42,55,55,136,559
2017,Rodney Hood,SG,24,UTA,59,55,1593,272,666,.408,114,307,.371,158,359,.440,.494,90,115,.783,16,186,202,96,38,11,65,132,748
2017,Al Horford,C,30,BOS,68,68,2193,379,801,.473,86,242,.355,293,559,.524,.527,108,135,.800,95,370,465,337,52,86,115,138,952
2017,Danuel House Jr.,SG,23,WAS,1,0,1,0,0,,0,0,,0,0,,,0,0,,0,1,1,0,0,0,0,0,0
2017,Dwight Howard,C,31,ATL,74,74,2199,388,613,.633,0,2,.000,388,611,.635,.633,226,424,.533,296,644,940,104,64,92,170,203,1002
2017,Marcelo Huertas,PG,33,LAL,23,1,237,25,68,.368,4,19,.211,21,49,.429,.397,9,17,.529,2,22,24,52,10,2,19,16,63
2017,Josh Huestis,PF,25,OKC,2,0,31,6,11,.545,2,4,.500,4,7,.571,.636,0,1,.000,4,5,9,3,0,3,0,0,14
2017,Kris Humphries,PF,31,ATL,56,4,689,87,214,.407,19,54,.352,68,160,.425,.451,64,82,.780,60,146,206,29,15,21,28,69,257
2017,R.J. Hunter,SG,23,CHI,3,0,9,0,1,.000,0,1,.000,0,0,,.000,0,0,,0,1,1,0,0,0,0,0,0
2017,Serge Ibaka,PF,27,TOT,79,79,2422,471,982,.480,124,317,.391,347,665,.522,.543,107,125,.856,129,409,538,75,41,124,105,215,1173
2017,Andre Iguodala,SF,33,GSW,76,0,1998,219,415,.528,64,177,.362,155,238,.651,.605,72,102,.706,51,253,304,261,76,39,58,97,574
2017,Ersan İlyasova,PF,29,TOT,82,52,2142,384,890,.431,142,402,.353,242,488,.496,.511,161,207,.778,115,366,481,141,58,23,116,211,1071
2017,Joe Ingles,SF,29,UTA,82,26,1972,204,451,.452,123,279,.441,81,172,.471,.589,50,68,.735,23,238,261,225,96,8,107,163,581
2017,Brandon Ingram,SF,19,LAL,79,40,2279,276,686,.402,55,187,.294,221,499,.443,.442,133,214,.621,60,256,316,166,50,36,116,158,740
2017,Kyrie Irving,PG,24,CLE,72,72,2525,671,1420,.473,177,441,.401,494,979,.505,.535,297,328,.905,52,178,230,418,83,24,180,157,1816
2017,Jarrett Jack,PG,33,NOP,2,0,33,2,3,.667,0,1,.000,2,2,1.000,.667,2,2,1.000,0,0,0,5,2,0,3,4,6
2017,Demetrius Jackson,PG,22,BOS,5,0,17,3,4,.750,1,1,1.000,2,3,.667,.875,3,6,.500,2,2,4,3,0,0,0,0,10
2017,Pierre Jackson,PG,25,DAL,8,1,84,13,39,.333,3,11,.273,10,28,.357,.372,6,7,.857,1,8,9,19,2,0,3,5,35
2017,Reggie Jackson,PG,26,DET,52,50,1424,284,677,.419,66,184,.359,218,493,.442,.468,118,136,.868,21,93,114,270,35,5,114,129,752
2017,LeBron James,SF,32,CLE,74,74,2794,736,1344,.548,124,342,.363,612,1002,.611,.594,358,531,.674,97,542,639,646,92,44,303,134,1954
2017,Al Jefferson,C,32,IND,66,1,931,235,471,.499,0,1,.000,235,470,.500,.499,65,85,.765,75,203,278,57,19,16,33,125,535
2017,Richard Jefferson,SF,36,CLE,79,13,1614,153,343,.446,62,186,.333,91,157,.580,.536,80,108,.741,28,175,203,78,26,10,52,153,448
2017,John Jenkins,SG,25,PHO,4,0,13,2,5,.400,1,2,.500,1,3,.333,.500,2,2,1.000,0,1,1,1,0,0,0,0,7
2017,Brandon Jennings,PG,27,TOT,81,13,1802,192,535,.359,79,252,.313,113,283,.399,.433,114,152,.750,29,167,196,395,70,4,128,116,577
2017,Jonas Jerebko,PF,29,BOS,78,6,1232,114,262,.435,45,130,.346,69,132,.523,.521,26,37,.703,59,213,272,71,25,17,39,122,299
2017,Amir Johnson,PF,29,BOS,80,77,1608,213,370,.576,27,66,.409,186,304,.612,.612,67,100,.670,118,248,366,140,51,62,77,211,520
2017,Brice Johnson,PF,22,LAC,3,0,9,2,7,.286,0,0,,2,7,.286,.286,0,0,,1,2,3,1,2,1,1,0,4
2017,James Johnson,PF,29,MIA,76,5,2085,368,769,.479,87,256,.340,281,513,.548,.535,152,215,.707,66,310,376,276,76,86,171,197,975
2017,Joe Johnson,SF,35,UTA,78,14,1843,273,626,.436,106,258,.411,167,368,.454,.521,63,77,.818,33,210,243,144,36,18,69,93,715
2017,Stanley Johnson,SF,20,DET,77,1,1371,129,365,.353,45,154,.292,84,211,.398,.415,36,53,.679,36,153,189,105,56,24,71,121,339
2017,Tyler Johnson,PG,24,MIA,73,0,2178,357,824,.433,93,250,.372,264,574,.460,.490,195,254,.768,50,243,293,233,84,44,90,176,1002
2017,Wesley Johnson,SF,29,LAC,68,3,810,73,200,.365,29,118,.246,44,82,.537,.438,11,17,.647,26,155,181,23,29,30,18,83,186
2017,Nikola Jokić,C,21,DEN,73,59,2038,494,854,.578,45,139,.324,449,715,.628,.605,188,228,.825,212,506,718,359,61,55,171,214,1221
2017,Dahntay Jones,SF,36,CLE,1,0,12,3,8,.375,0,2,.000,3,6,.500,.375,3,4,.750,1,1,2,1,0,0,1,1,9
2017,Damian Jones,C,21,GSW,10,0,85,8,16,.500,0,0,,8,16,.500,.500,3,10,.300,9,14,23,0,1,4,6,15,19
2017,Derrick Jones Jr.,SF,19,PHO,32,8,545,68,121,.562,3,11,.273,65,110,.591,.574,29,41,.707,39,40,79,12,14,13,13,63,168
2017,James Jones,SF,36,CLE,48,2,381,44,92,.478,31,66,.470,13,26,.500,.647,13,20,.650,3,34,37,14,6,10,10,37,132
2017,Terrence Jones,PF,25,TOT,54,12,1270,231,492,.470,19,75,.253,212,417,.508,.489,103,170,.606,65,241,306,59,40,54,48,67,584
2017,Tyus Jones,PG,20,MIN,60,0,774,75,181,.414,26,73,.356,49,108,.454,.486,33,43,.767,10,57,67,156,48,5,38,50,209
2017,DeAndre Jordan,C,28,LAC,81,81,2570,412,577,.714,0,2,.000,412,575,.717,.714,205,425,.482,298,816,1114,96,51,134,115,212,1029
2017,Cory Joseph,PG,25,TOR,80,22,2003,299,661,.452,48,135,.356,251,526,.477,.489,94,122,.770,51,184,235,265,66,13,108,140,740
2017,Frank Kaminsky,C,23,CHO,75,16,1954,320,802,.399,116,354,.328,204,448,.455,.471,118,156,.756,57,279,336,162,46,34,76,139,874
2017,Ryan Kelly,PF,25,ATL,16,0,110,8,28,.286,4,10,.400,4,18,.222,.357,5,6,.833,1,17,18,8,4,5,4,5,25
2017,Michael Kidd-Gilchrist,SF,23,CHO,81,81,2349,295,618,.477,1,9,.111,294,609,.483,.478,152,194,.784,156,409,565,114,81,77,56,187,743
2017,Sean Kilpatrick,SG,27,BRK,70,24,1754,305,735,.415,105,308,.341,200,427,.468,.486,204,242,.843,22,258,280,157,45,6,135,118,919
2017,Brandon Knight,SG,25,PHO,54,5,1140,209,525,.398,45,139,.324,164,386,.425,.441,132,154,.857,25,93,118,130,27,5,88,87,595
2017,Kyle Korver,SG,35,TOT,67,22,1753,239,515,.464,162,359,.451,77,156,.494,.621,38,42,.905,7,179,186,110,34,21,69,107,678
2017,Kosta Koufos,C,27,SAC,71,62,1419,216,392,.551,0,1,.000,216,391,.552,.551,38,62,.613,118,285,403,47,36,48,61,172,470
2017,Mindaugas Kuzminskas,SF,27,NYK,68,5,1016,158,369,.428,54,168,.321,104,201,.517,.501,55,68,.809,47,79,126,69,29,11,51,79,425
2017,Skal Labissière,PF,20,SAC,33,12,612,117,218,.537,3,8,.375,114,210,.543,.544,52,74,.703,51,111,162,27,16,13,37,64,289
2017,Jeremy Lamb,SG,24,CHO,62,5,1143,226,491,.460,41,146,.281,185,345,.536,.502,110,129,.853,30,234,264,75,27,23,40,98,603
2017,Nicolás Laprovíttola,PG,27,SAS,18,3,174,20,47,.426,10,27,.370,10,20,.500,.532,9,9,1.000,1,9,10,28,4,1,19,19,59
2017,Joffrey Lauvergne,PF-C,25,TOT,70,1,980,148,336,.440,33,98,.337,115,238,.483,.490,46,73,.630,72,179,251,70,25,6,56,83,375
2017,Zach LaVine,SG,21,MIN,47,47,1749,326,710,.459,120,310,.387,206,400,.515,.544,117,140,.836,19,141,160,139,41,10,85,104,889
2017,Ty Lawson,PG,29,SAC,69,24,1732,237,522,.454,34,118,.288,203,404,.502,.487,173,217,.797,44,135,179,334,74,6,129,119,681
2017,Jake Layman,SF,22,POR,35,1,249,26,89,.292,13,51,.255,13,38,.342,.365,13,17,.765,6,18,24,11,9,3,11,22,78
2017,Courtney Lee,SG,31,NYK,77,74,2459,321,704,.456,108,269,.401,213,435,.490,.533,85,98,.867,53,206,259,179,81,24,69,141,835
2017,David Lee,PF,33,SAS,79,10,1477,248,420,.590,0,0,,248,420,.590,.590,80,113,.708,149,292,441,124,31,40,82,125,576
2017,Alex Len,C,23,PHO,77,34,1560,230,463,.497,3,12,.250,227,451,.503,.500,150,208,.721,156,354,510,44,38,98,102,242,613
2017,Kawhi Leonard,SF,25,SAS,74,74,2474,636,1312,.485,147,387,.380,489,925,.529,.541,469,533,.880,80,350,430,260,133,55,154,122,1888
2017,Meyers Leonard,PF,24,POR,74,12,1222,146,378,.386,74,213,.347,72,165,.436,.484,35,40,.875,27,210,237,71,13,28,35,172,401
2017,Jon Leuer,PF,27,DET,75,34,1944,310,646,.480,49,167,.293,261,479,.545,.518,98,113,.867,102,300,402,111,31,26,66,145,767
2017,Caris LeVert,SF,22,BRK,57,26,1237,171,380,.450,59,184,.321,112,196,.571,.528,67,93,.720,23,165,188,110,49,8,59,91,468
2017,DeAndre Liggins,SG,28,TOT,62,19,777,55,142,.387,17,46,.370,38,96,.396,.447,25,40,.625,20,88,108,54,47,14,42,81,152
2017,Damian Lillard,PG,26,POR,75,75,2694,661,1488,.444,214,579,.370,447,909,.492,.516,488,545,.895,46,322,368,440,68,20,197,152,2024
2017,Jeremy Lin,PG,28,BRK,36,33,883,175,400,.438,58,156,.372,117,244,.480,.510,115,141,.816,11,124,135,184,42,14,86,79,523
2017,Shaun Livingston,PG,31,GSW,76,3,1345,173,316,.547,1,3,.333,172,313,.550,.549,42,60,.700,28,123,151,139,38,20,62,120,389
2017,Shawn Long,C,24,PHI,18,0,234,61,109,.560,7,19,.368,54,90,.600,.592,19,35,.543,41,44,85,13,9,9,13,49,148
2017,Kevon Looney,C,20,GSW,53,4,447,56,107,.523,2,9,.222,54,98,.551,.533,21,34,.618,44,80,124,29,15,17,17,64,135
2017,Brook Lopez,C,28,BRK,75,75,2222,555,1172,.474,134,387,.346,421,785,.536,.531,295,364,.810,121,282,403,176,38,124,184,192,1539
2017,Robin Lopez,C,28,CHI,81,81,2271,382,775,.493,0,2,.000,382,773,.494,.493,75,104,.721,244,276,520,80,18,117,91,151,839
2017,Kevin Love,PF,28,CLE,60,60,1885,370,867,.427,145,389,.373,225,478,.471,.510,257,295,.871,148,518,666,116,53,21,122,125,1142
2017,Kyle Lowry,PG,30,TOR,60,60,2244,426,918,.464,193,468,.412,233,450,.518,.569,299,365,.819,48,238,286,417,88,19,173,170,1344
2017,John Lucas III,PG,34,MIN,5,0,11,1,4,.250,0,1,.000,1,3,.333,.250,0,0,,0,0,0,1,2,0,0,0,2
2017,Timothé Luwawu-Cabarrot,SF,21,PHI,69,19,1190,145,361,.402,50,161,.311,95,200,.475,.471,105,123,.854,25,124,149,75,32,10,73,154,445
2017,Trey Lyles,PF,21,UTA,71,4,1158,159,439,.362,65,204,.319,94,235,.400,.436,57,79,.722,48,187,235,69,26,20,64,97,440
2017,Sheldon Mac,SG,24,WAS,30,3,287,30,75,.400,7,30,.233,23,45,.511,.447,23,27,.852,4,30,34,15,8,2,5,17,90
2017,Shelvin Mack,PG,26,UTA,55,9,1205,170,381,.446,37,120,.308,133,261,.510,.495,53,77,.688,20,105,125,154,42,3,90,100,430
2017,Ian Mahinmi,C,30,WAS,31,0,555,65,111,.586,0,0,,65,111,.586,.586,43,75,.573,47,103,150,19,33,24,34,90,173
2017,Thon Maker,C,19,MIL,57,34,562,83,181,.459,28,74,.378,55,107,.514,.536,32,49,.653,40,74,114,23,10,26,17,84,226
2017,Boban Marjanović,C,28,DET,35,0,293,72,132,.545,0,0,,72,132,.545,.545,47,58,.810,46,84,130,9,6,12,10,25,191
2017,Jarell Martin,PF,22,MEM,42,3,558,58,151,.384,9,25,.360,49,126,.389,.414,40,50,.800,42,120,162,8,17,9,28,91,165
2017,Wesley Matthews,SG,30,DAL,73,73,2495,333,847,.393,174,479,.363,159,368,.432,.496,146,179,.816,18,241,259,210,77,15,102,161,986
2017,Luc Mbah a Moute,SF,30,LAC,80,76,1787,191,378,.505,43,110,.391,148,268,.552,.562,59,87,.678,44,126,170,39,81,35,46,122,484
2017,James Michael McAdoo,PF,24,GSW,52,2,457,62,117,.530,2,8,.250,60,109,.550,.538,21,42,.500,34,57,91,18,18,29,19,47,147
2017,Patrick McCaw,SG,21,GSW,71,20,1074,106,245,.433,41,123,.333,65,122,.533,.516,29,37,.784,21,79,100,77,32,15,36,62,282
2017,CJ McCollum,SG,25,POR,80,80,2796,692,1441,.480,185,439,.421,507,1002,.506,.544,268,294,.912,60,229,289,285,72,42,172,202,1837
2017,T.J. McConnell,PG,24,PHI,81,51,2133,236,512,.461,11,55,.200,225,457,.492,.472,73,90,.811,39,212,251,534,134,10,159,139,556
2017,Chris McCullough,PF,21,TOT,16,0,80,16,32,.500,1,7,.143,15,25,.600,.516,3,5,.600,9,10,19,2,2,2,3,7,36
2017,K.J. McDaniels,SF,23,TOT,49,0,505,77,169,.456,20,66,.303,57,103,.553,.515,32,38,.842,15,67,82,13,19,18,29,49,206
2017,Doug McDermott,SF,25,TOT,66,5,1508,222,497,.447,77,208,.370,145,289,.502,.524,71,84,.845,20,159,179,58,13,5,38,79,592
2017,JaVale McGee,C,29,GSW,77,10,739,208,319,.652,0,3,.000,208,316,.658,.652,56,111,.505,100,144,244,17,19,67,40,109,472
2017,Rodney McGruder,SG,25,MIA,78,65,1966,190,460,.413,73,220,.332,117,240,.488,.492,44,71,.620,94,162,256,124,46,18,56,140,497
2017,Ben McLemore,SG,23,SAC,61,26,1176,180,419,.430,65,170,.382,115,249,.462,.507,70,93,.753,19,110,129,51,29,6,62,108,495
2017,Jordan McRae,SG,25,CLE,37,4,384,58,150,.387,18,51,.353,40,99,.404,.447,27,34,.794,6,35,41,19,8,6,14,31,161
2017,Josh McRoberts,PF,29,MIA,22,14,381,44,118,.373,13,31,.419,31,87,.356,.428,6,9,.667,23,51,74,50,10,4,23,31,107
2017,Jodie Meeks,SG,29,ORL,36,10,738,103,256,.402,56,137,.409,47,119,.395,.512,65,74,.878,5,72,77,45,34,4,36,41,327
2017,Salah Mejri,C,30,DAL,73,11,905,88,137,.642,1,3,.333,87,134,.649,.646,36,61,.590,97,211,308,14,32,61,40,152,213
2017,Jordan Mickey,PF,22,BOS,25,1,141,15,34,.441,0,1,.000,15,33,.455,.441,8,14,.571,13,21,34,7,3,6,9,12,38
2017,Khris Middleton,SF,25,MIL,29,23,889,150,333,.450,45,104,.433,105,229,.459,.518,81,92,.880,11,112,123,99,41,7,65,79,426
2017,C.J. Miles,SF,29,IND,76,29,1776,281,647,.434,169,409,.413,112,238,.471,.565,84,93,.903,30,199,229,48,46,25,40,151,815
2017,Mike Miller,SF,36,DEN,20,0,151,9,23,.391,8,20,.400,1,3,.333,.565,2,2,1.000,2,36,38,22,2,0,13,9,28
2017,Patty Mills,PG,28,SAS,80,8,1754,273,621,.440,147,355,.414,126,266,.474,.558,66,80,.825,24,117,141,280,65,3,101,109,759
2017,Elijah Millsap,SG,29,PHO,2,0,23,1,7,.143,0,2,.000,1,5,.200,.143,1,2,.500,3,3,6,1,0,0,2,2,3
2017,Paul Millsap,PF,31,ATL,69,67,2343,430,972,.442,75,241,.311,355,731,.486,.481,311,405,.768,111,422,533,252,90,62,158,186,1246
2017,Nikola Mirotić,PF,25,CHI,70,15,1679,258,625,.413,129,377,.342,129,248,.520,.516,99,128,.773,61,323,384,75,53,55,80,128,744
2017,Greg Monroe,C,26,MIL,81,0,1823,387,726,.533,0,4,.000,387,722,.536,.533,177,239,.741,167,365,532,187,92,38,140,168,951
2017,E'Twaun Moore,SG,27,NOP,73,22,1820,283,619,.457,77,208,.370,206,411,.501,.519,57,74,.770,33,119,152,164,50,32,62,131,700
2017,Marcus Morris,SF,27,DET,79,79,2565,421,1007,.418,118,357,.331,303,650,.466,.477,145,185,.784,77,289,366,160,52,25,87,168,1105
2017,Markieff Morris,PF,27,WAS,76,76,2374,406,889,.457,71,196,.362,335,693,.483,.497,180,215,.837,107,386,493,126,82,42,129,254,1063
2017,Anthony Morrow,SG,31,TOT,49,7,714,98,252,.389,41,133,.308,57,119,.479,.470,34,37,.919,12,19,31,25,24,2,6,44,271
2017,Donatas Motiejūnas,PF,26,NOP,34,0,479,57,138,.413,11,47,.234,46,91,.505,.453,25,49,.510,26,75,101,32,18,11,31,55,150
2017,Timofey Mozgov,C,30,LAL,54,52,1104,169,328,.515,0,1,.000,169,327,.517,.515,63,78,.808,104,160,264,43,16,31,72,133,401
2017,Emmanuel Mudiay,PG,20,DEN,55,41,1406,208,551,.377,56,178,.315,152,373,.408,.428,131,167,.784,29,149,178,217,41,13,123,95,603
2017,Shabazz Muhammad,SF,24,MIN,78,1,1516,288,598,.482,49,145,.338,239,453,.528,.523,147,190,.774,84,136,220,35,22,6,56,86,772
2017,Dejounte Murray,PG,20,SAS,38,8,322,50,116,.431,9,23,.391,41,93,.441,.470,21,30,.700,6,36,42,48,8,6,38,29,130
2017,Jamal Murray,SG,19,DEN,82,10,1764,295,730,.404,115,344,.334,180,386,.466,.483,106,120,.883,41,173,214,170,51,24,113,124,811
2017,Mike Muscala,C,25,ATL,70,3,1237,170,337,.504,46,110,.418,124,227,.546,.573,49,64,.766,76,164,240,95,30,41,55,97,435
2017,Larry Nance Jr.,PF,24,LAL,63,7,1442,190,361,.526,10,36,.278,180,325,.554,.540,59,80,.738,120,249,369,96,82,39,56,149,449
2017,Shabazz Napier,PG,25,POR,53,2,512,73,183,.399,34,92,.370,39,91,.429,.492,38,49,.776,8,53,61,67,32,2,41,38,218
2017,Maurice Ndour,PF,24,NYK,32,4,331,39,86,.453,1,7,.143,38,79,.481,.459,19,26,.731,22,42,64,8,15,8,12,30,98
2017,Gary Neal,SG,32,ATL,2,0,18,0,7,.000,0,2,.000,0,5,.000,.000,4,4,1.000,0,1,1,1,0,0,0,1,4
2017,Jameer Nelson,PG,34,DEN,75,39,2045,268,604,.444,106,273,.388,162,331,.489,.531,45,63,.714,28,164,192,385,54,8,128,197,687
2017,Raul Neto,PG,24,UTA,40,0,346,41,91,.451,10,31,.323,31,60,.517,.505,8,9,.889,4,26,30,34,21,5,15,48,100
2017,Georges Niang,PF,23,IND,23,0,93,9,36,.250,1,12,.083,8,24,.333,.264,2,2,1.000,2,15,17,5,3,0,5,6,21
2017,Andrew Nicholson,PF,27,TOT,38,0,342,43,111,.387,5,27,.185,38,84,.452,.410,9,14,.643,15,46,61,10,16,6,17,55,100
2017,Joakim Noah,C,31,NYK,46,46,1015,99,202,.490,0,1,.000,99,201,.493,.490,34,78,.436,162,241,403,103,30,37,58,127,232
2017,Nerlens Noel,C,22,TOT,51,19,1047,184,309,.595,0,1,.000,184,308,.597,.595,77,111,.694,93,201,294,50,65,50,51,126,445
2017,Lucas Nogueira,C,24,TOR,57,6,1088,103,156,.660,3,12,.250,100,144,.694,.670,44,67,.657,82,162,244,42,52,89,46,137,253
2017,Steve Novak,PF,33,MIL,8,0,22,2,7,.286,1,6,.167,1,1,1.000,.357,0,0,,0,3,3,0,0,0,0,1,5
2017,Dirk Nowitzki,PF,38,DAL,54,54,1424,296,678,.437,79,209,.378,217,469,.463,.495,98,112,.875,23,330,353,82,30,38,51,113,769
2017,Jusuf Nurkić,C,22,TOT,65,48,1391,271,534,.507,0,1,.000,271,533,.508,.507,120,210,.571,154,313,467,123,50,74,143,161,662
2017,David Nwaba,SG,24,LAL,20,2,397,47,81,.580,1,5,.200,46,76,.605,.586,25,39,.641,17,46,63,14,13,7,11,36,120
2017,Johnny O'Bryant,PF,23,TOT,11,0,80,15,30,.500,3,6,.500,12,24,.500,.550,5,6,.833,9,10,19,6,0,1,6,10,38
2017,Kyle O'Quinn,C,26,NYK,79,8,1229,215,413,.521,2,17,.118,213,396,.538,.523,64,83,.771,157,282,439,117,36,104,76,174,496
2017,Daniel Ochefu,C,23,WAS,19,0,75,12,27,.444,0,0,,12,27,.444,.444,0,2,.000,5,17,22,3,2,0,3,17,24
2017,Jahlil Okafor,C,21,PHI,50,33,1134,242,471,.514,0,0,,242,471,.514,.514,106,158,.671,81,159,240,58,20,49,91,122,590
2017,Victor Oladipo,SG,24,OKC,67,67,2222,412,932,.442,127,352,.361,285,580,.491,.510,116,154,.753,39,252,291,176,78,21,119,155,1067
2017,Kelly Olynyk,C,25,BOS,75,6,1538,260,508,.512,68,192,.354,192,316,.608,.579,90,123,.732,73,288,361,148,43,29,96,207,678
2017,Arinze Onuaku,C,29,ORL,8,0,28,2,4,.500,0,0,,2,4,.500,.500,0,0,,2,4,6,2,0,1,2,3,4
2017,Chinanu Onuaku,C,20,HOU,5,1,52,5,7,.714,0,0,,5,7,.714,.714,4,4,1.000,2,8,10,3,3,1,4,6,14
2017,Kelly Oubre Jr.,SF,21,WAS,79,5,1605,186,442,.421,54,188,.287,132,254,.520,.482,75,99,.758,61,200,261,47,58,17,50,195,501
2017,Zaza Pachulia,C,32,GSW,70,70,1268,164,307,.534,0,2,.000,164,305,.538,.534,98,126,.778,140,270,410,132,59,33,87,166,426
2017,Georgios Papagiannis,C,19,SAC,22,0,355,56,102,.549,0,2,.000,56,100,.560,.549,12,14,.857,24,62,86,20,3,17,24,44,124
2017,Jabari Parker,PF,21,MIL,51,50,1728,399,814,.490,65,178,.365,334,636,.525,.530,162,218,.743,79,235,314,142,50,22,93,111,1025
2017,Tony Parker,PG,34,SAS,63,63,1587,265,569,.466,23,69,.333,242,500,.484,.486,85,117,.726,9,104,113,285,34,2,89,92,638
2017,Chandler Parsons,SF,28,MEM,34,34,675,75,222,.338,25,93,.269,50,129,.388,.394,35,43,.814,6,78,84,55,20,5,24,52,210
2017,Lamar Patterson,SG,25,ATL,5,0,40,3,15,.200,1,6,.167,2,9,.222,.233,2,3,.667,1,6,7,6,1,0,4,6,9
2017,Patrick Patterson,PF,27,TOR,65,8,1599,154,384,.401,94,253,.372,60,131,.458,.523,43,60,.717,62,231,293,76,40,23,38,120,445
2017,Chris Paul,PG,31,LAC,61,61,1921,374,785,.476,124,302,.411,250,483,.518,.555,232,260,.892,40,264,304,563,119,8,147,146,1104
2017,Adreian Payne,PF,25,MIN,18,0,135,23,54,.426,3,15,.200,20,39,.513,.454,14,19,.737,9,24,33,7,8,7,8,32,63
2017,Cameron Payne,PG,22,TOT,31,0,462,64,193,.332,27,86,.314,37,107,.346,.402,5,8,.625,3,45,48,55,14,4,29,52,160
2017,Elfrid Payton,PG,22,ORL,82,58,2412,430,912,.471,40,146,.274,390,766,.509,.493,146,211,.692,89,298,387,529,88,40,178,177,1046
2017,Gary Payton II,PG,24,MIL,6,0,99,8,22,.364,1,9,.111,7,13,.538,.386,3,5,.600,0,12,12,13,3,4,10,9,20
2017,Paul Pierce,SF,39,LAC,25,7,277,28,70,.400,15,43,.349,13,27,.481,.507,10,13,.769,1,47,48,10,4,5,16,40,81
2017,Marshall Plumlee,C,24,NYK,21,1,170,16,30,.533,0,0,,16,30,.533,.533,8,19,.421,23,28,51,10,4,4,12,23,40
2017,Mason Plumlee,C,26,TOT,81,64,2148,334,623,.536,0,6,.000,334,617,.541,.536,174,300,.580,170,435,605,284,69,92,134,226,842
2017,Miles Plumlee,C,28,TOT,45,12,484,44,92,.478,0,0,,44,92,.478,.478,25,39,.641,38,57,95,21,18,13,30,73,113
2017,Jakob Poeltl,C,21,TOR,54,4,626,67,115,.583,0,0,,67,115,.583,.583,31,57,.544,78,87,165,12,17,20,29,113,165
2017,Otto Porter Jr.,SF,23,WAS,80,80,2605,414,803,.516,148,341,.434,266,462,.576,.608,99,119,.832,118,396,514,121,116,42,44,193,1075
2017,Bobby Portis,PF,21,CHI,64,13,1000,183,375,.488,32,96,.333,151,279,.541,.531,39,59,.661,75,221,296,35,16,11,37,94,437
2017,Kristaps Porziņģis,PF,21,NYK,66,65,2164,443,985,.450,112,314,.357,331,671,.493,.507,198,252,.786,111,364,475,97,47,129,118,244,1196
2017,Dwight Powell,C,25,DAL,77,3,1333,194,377,.515,21,74,.284,173,303,.571,.542,107,141,.759,93,213,306,49,61,39,34,135,516
2017,Norman Powell,SG,23,TOR,76,18,1368,227,506,.449,56,173,.324,171,333,.514,.504,126,159,.792,26,143,169,82,52,14,70,127,636
2017,Alex Poythress,PF,23,PHI,6,1,157,25,54,.463,6,19,.316,19,35,.543,.519,8,10,.800,11,18,29,5,3,2,3,14,64
2017,Ronnie Price,PG,33,PHO,14,0,134,4,24,.167,3,17,.176,1,7,.143,.229,3,4,.750,3,8,11,18,11,1,3,14,14
2017,Taurean Prince,SF,22,ATL,59,10,981,114,285,.400,33,102,.324,81,183,.443,.458,74,94,.787,25,132,157,55,43,27,61,96,335
2017,Tim Quarterman,SG,22,POR,16,0,80,13,29,.448,5,13,.385,8,16,.500,.534,0,3,.000,4,10,14,11,2,3,11,6,31
2017,Chasson Randle,PG,23,TOT,26,0,299,40,98,.408,16,47,.340,24,51,.471,.490,41,43,.953,6,26,32,34,9,2,19,39,137
2017,Julius Randle,PF,22,LAL,74,73,2132,377,773,.488,17,63,.270,360,710,.507,.499,204,282,.723,150,486,636,264,49,37,173,248,975
2017,Zach Randolph,PF,35,MEM,73,5,1786,433,964,.449,21,94,.223,412,870,.474,.460,141,193,.731,182,416,598,122,38,10,99,136,1028
2017,J.J. Redick,SG,32,LAC,78,78,2198,396,890,.445,201,468,.429,195,422,.462,.558,180,202,.891,11,160,171,110,54,13,98,125,1173
2017,Willie Reed,C,26,MIA,71,5,1031,162,285,.568,1,4,.250,161,281,.573,.570,49,88,.557,129,203,332,26,18,47,31,137,374
2017,Josh Richardson,SG,23,MIA,53,34,1614,202,513,.394,75,227,.330,127,286,.444,.467,60,77,.779,35,133,168,140,60,39,65,132,539
2017,Malachi Richardson,SG,21,SAC,22,0,198,28,68,.412,8,28,.286,20,40,.500,.471,15,19,.789,3,20,23,11,5,1,8,23,79
2017,Austin Rivers,SG,24,LAC,74,29,2054,323,731,.442,111,299,.371,212,432,.491,.518,132,191,.691,20,141,161,204,48,10,115,187,889
2017,Andre Roberson,SF,25,OKC,79,79,2376,215,463,.464,45,184,.245,170,279,.609,.513,47,111,.423,98,305,403,79,94,79,51,204,522
2017,Brian Roberts,PG,31,CHO,41,2,416,46,122,.377,17,44,.386,29,78,.372,.447,33,39,.846,5,34,39,52,9,1,26,18,142
2017,Glenn Robinson III,SF,23,IND,69,27,1427,158,338,.467,49,125,.392,109,213,.512,.540,54,76,.711,57,189,246,47,41,20,37,63,419
2017,Thomas Robinson,PF,25,LAL,48,1,560,105,196,.536,0,1,.000,105,195,.538,.536,31,66,.470,84,139,223,31,26,9,46,76,241
2017,Sergio Rodríguez,PG,30,PHI,68,30,1518,210,536,.392,92,252,.365,118,284,.415,.478,18,27,.667,21,136,157,344,49,4,128,95,530
2017,Rajon Rondo,PG,30,CHI,69,42,1843,229,561,.408,50,133,.376,179,428,.418,.453,30,50,.600,73,282,355,461,99,11,169,144,538
2017,Derrick Rose,PG,28,NYK,64,64,2082,460,977,.471,13,60,.217,447,917,.487,.477,221,253,.874,66,180,246,283,44,17,147,84,1154
2017,Terrence Ross,SF,25,TOT,78,24,1955,326,746,.437,142,391,.363,184,355,.518,.532,64,77,.831,18,188,206,88,87,33,68,143,858
2017,Terry Rozier,PG,22,BOS,74,0,1263,151,411,.367,57,179,.318,94,232,.405,.437,51,66,.773,40,187,227,131,46,11,47,69,410
2017,Ricky Rubio,PG,26,MIN,75,75,2469,261,650,.402,60,196,.306,201,454,.443,.448,254,285,.891,68,237,305,682,128,10,195,202,836
2017,Damjan Rudež,SF,30,ORL,45,0,314,31,88,.352,20,64,.313,11,24,.458,.466,0,0,,5,20,25,20,12,1,9,31,82
2017,Brandon Rush,SG,31,MIN,47,33,1030,70,187,.374,44,114,.386,26,73,.356,.492,13,18,.722,16,83,99,45,22,23,28,42,197
2017,D'Angelo Russell,PG,20,LAL,63,60,1811,351,867,.405,135,384,.352,216,483,.447,.483,147,188,.782,31,190,221,303,87,16,176,130,984
2017,Domantas Sabonis,PF,20,OKC,81,66,1632,192,481,.399,51,159,.321,141,322,.438,.452,44,67,.657,46,242,288,82,39,32,83,200,479
2017,Larry Sanders,C,28,CLE,5,0,13,1,4,.250,0,0,,1,4,.250,.250,2,2,1.000,3,1,4,0,1,1,2,5,4
2017,Dario Šarić,PF,22,PHI,81,36,2129,381,927,.411,106,341,.311,275,586,.469,.468,172,220,.782,112,401,513,182,57,30,183,162,1040
2017,Tomáš Satoranský,SG,25,WAS,57,3,719,61,147,.415,9,37,.243,52,110,.473,.446,23,33,.697,25,58,83,92,26,6,38,60,154
2017,Dennis Schröder,PG,23,ATL,79,78,2485,548,1214,.451,100,294,.340,448,920,.487,.493,218,255,.855,42,206,248,499,74,16,258,149,1414
2017,Luis Scola,PF,36,BRK,36,1,461,71,151,.470,17,50,.340,54,101,.535,.526,25,37,.676,51,88,139,37,14,4,34,63,184
2017,Mike Scott,PF,28,ATL,18,0,195,17,59,.288,4,27,.148,13,32,.406,.322,7,8,.875,10,27,37,17,4,3,8,12,45
2017,Thabo Sefolosha,SF,32,ATL,62,42,1596,174,395,.441,41,120,.342,133,275,.484,.492,55,75,.733,54,216,270,107,96,31,58,97,444
2017,Wayne Selden,SG,22,TOT,14,5,236,25,58,.431,7,28,.250,18,30,.600,.491,14,22,.636,1,15,16,13,6,1,12,18,71
2017,Kevin Séraphin,PF,27,IND,49,3,559,109,198,.551,0,2,.000,109,196,.556,.551,14,22,.636,41,101,142,23,7,20,29,66,232
2017,Ramon Sessions,PG,30,CHO,50,1,811,100,263,.380,21,62,.339,79,201,.393,.420,91,118,.771,11,62,73,129,27,3,46,43,312
2017,Iman Shumpert,SG,26,CLE,76,31,1937,201,489,.411,94,261,.360,107,228,.469,.507,71,90,.789,39,179,218,109,62,27,78,150,567
2017,Pascal Siakam,PF,22,TOR,55,38,859,103,205,.502,1,7,.143,102,198,.515,.505,22,32,.688,64,121,185,17,26,45,33,109,229
2017,Jonathon Simmons,SG,27,SAS,78,8,1392,177,421,.420,30,102,.294,147,319,.461,.456,99,132,.750,20,140,160,126,47,25,76,146,483
2017,Kyle Singler,SF,28,OKC,32,2,385,34,83,.410,7,37,.189,27,46,.587,.452,13,17,.765,8,40,48,9,7,5,11,29,88
2017,Marcus Smart,SG,22,BOS,79,24,2399,269,749,.359,94,332,.283,175,417,.420,.422,203,250,.812,78,227,305,364,125,34,159,192,835
2017,Ish Smith,PG,28,DET,81,32,1955,329,749,.439,28,105,.267,301,644,.467,.458,72,102,.706,21,214,235,418,61,33,112,127,758
2017,J.R. Smith,SG,31,CLE,41,35,1187,123,356,.346,95,271,.351,28,85,.329,.479,10,15,.667,17,96,113,62,40,11,26,77,351
2017,Jason Smith,C,30,WAS,74,3,1068,174,329,.529,37,78,.474,137,251,.546,.585,35,51,.686,64,194,258,37,21,54,58,168,420
2017,Tony Snell,SG,25,MIL,80,80,2336,246,541,.455,144,355,.406,102,186,.548,.588,47,58,.810,22,226,248,96,55,14,55,125,683
2017,Marreese Speights,C,29,LAC,82,2,1286,244,548,.445,103,277,.372,141,271,.520,.539,120,137,.876,88,285,373,65,23,41,69,229,711
2017,Tiago Splitter,C,32,PHI,8,0,76,14,31,.452,2,6,.333,12,25,.480,.484,9,11,.818,8,14,22,4,1,1,6,8,39
2017,Nik Stauskas,SG,23,PHI,80,27,2188,251,634,.396,132,359,.368,119,275,.433,.500,122,150,.813,21,205,226,188,45,32,128,144,756
2017,Lance Stephenson,SG,26,TOT,18,0,361,54,120,.450,6,20,.300,48,100,.480,.475,8,13,.615,4,48,52,59,5,3,26,32,122
2017,Jarnell Stokes,C,23,DEN,2,0,7,1,1,1.000,0,0,,1,1,1.000,1.000,1,2,.500,1,1,2,2,1,0,0,3,3
2017,Diamond Stone,C,19,LAC,7,0,24,3,13,.231,0,0,,3,13,.231,.231,4,4,1.000,1,5,6,0,0,1,2,5,10
2017,Rodney Stuckey,PG,30,IND,39,0,696,91,244,.373,19,60,.317,72,184,.391,.412,80,107,.748,6,78,84,84,16,0,53,44,281
2017,Jared Sullinger,PF,24,TOR,11,1,118,15,47,.319,3,18,.167,12,29,.414,.351,4,8,.500,10,17,27,3,4,1,4,17,37
2017,Edy Tavares,C,24,TOT,2,0,28,4,5,.800,0,0,,4,5,.800,.800,0,3,.000,4,7,11,1,0,6,2,3,8
2017,Isaiah Taylor,PG,22,HOU,4,0,52,1,7,.143,0,2,.000,1,5,.200,.143,1,2,.500,1,2,3,3,1,1,0,6,3
2017,Jeff Teague,PG,28,IND,82,82,2657,402,909,.442,90,252,.357,312,657,.475,.492,360,415,.867,33,297,330,639,100,32,216,165,1254
2017,Mirza Teletović,PF,31,MIL,70,2,1133,156,418,.373,104,305,.341,52,113,.460,.498,35,45,.778,11,151,162,48,12,13,37,109,451
2017,Garrett Temple,SG,30,SAC,65,21,1728,183,432,.424,82,220,.373,101,212,.476,.519,58,74,.784,32,152,184,168,84,28,78,141,506
2017,Jason Terry,SG,39,MIL,74,0,1365,105,243,.432,73,171,.427,32,72,.444,.582,24,29,.828,15,91,106,98,46,20,36,95,307
2017,Isaiah Thomas,PG,27,BOS,76,76,2569,682,1473,.463,245,646,.379,437,827,.528,.546,590,649,.909,43,162,205,448,70,13,210,167,2199
2017,Lance Thomas,PF,28,NYK,46,15,968,97,244,.398,38,85,.447,59,159,.371,.475,43,51,.843,32,110,142,35,21,5,25,85,275
2017,Hollis Thompson,SG,25,TOT,40,9,752,77,200,.385,32,95,.337,45,105,.429,.465,19,29,.655,19,93,112,35,20,6,11,69,205
2017,Klay Thompson,SG,26,GSW,78,78,2649,644,1376,.468,268,647,.414,376,729,.516,.565,186,218,.853,49,236,285,160,66,40,128,139,1742
2017,Tristan Thompson,C,25,CLE,78,78,2336,262,437,.600,0,3,.000,262,434,.604,.600,106,213,.498,286,429,715,77,39,84,64,176,630
2017,Marcus Thornton,SG,29,WAS,33,1,575,84,210,.400,28,80,.350,56,130,.431,.467,23,27,.852,22,54,76,41,19,3,25,48,219
2017,Mike Tobey,C,22,CHO,2,0,25,1,4,.250,0,0,,1,4,.250,.250,0,0,,2,1,3,1,0,0,1,2,2
2017,Anthony Tolliver,PF,31,SAC,65,9,1477,155,351,.442,90,230,.391,65,121,.537,.570,61,82,.744,51,186,237,77,34,20,56,109,461
2017,Axel Toupane,SF,24,TOT,4,0,47,5,9,.556,1,4,.250,4,5,.800,.611,0,0,,0,1,1,0,1,1,0,6,11
2017,Karl-Anthony Towns,C,21,MIN,82,82,3030,802,1480,.542,101,275,.367,701,1205,.582,.576,356,428,.832,296,711,1007,220,56,103,212,241,2061
2017,P.J. Tucker,SF,31,TOT,81,21,2236,199,482,.413,70,196,.357,129,286,.451,.485,72,93,.774,117,354,471,99,116,19,66,196,540
2017,Evan Turner,SF,28,POR,65,12,1658,235,552,.426,31,118,.263,204,434,.470,.454,85,103,.825,36,211,247,205,53,24,100,121,586
2017,Myles Turner,C,20,IND,81,81,2541,444,869,.511,40,115,.348,404,754,.536,.534,245,303,.809,139,450,589,106,74,172,105,262,1173
2017,Beno Udrih,PG,34,DET,39,0,560,92,197,.467,11,32,.344,81,165,.491,.495,32,34,.941,6,51,57,131,13,0,36,29,227
2017,Tyler Ulis,PG,21,PHO,61,15,1123,184,437,.421,21,79,.266,163,358,.455,.445,55,71,.775,20,75,95,226,48,5,77,73,444
2017,Jarrod Uthoff,PF,23,DAL,9,0,115,16,38,.421,3,9,.333,13,29,.448,.461,5,7,.714,8,14,22,9,2,4,3,8,40
2017,Jonas Valančiūnas,C,24,TOR,80,80,2066,391,702,.557,1,2,.500,390,700,.557,.558,176,217,.811,226,533,759,57,37,63,106,216,959
2017,Denzel Valentine,SG,23,CHI,57,0,976,102,288,.354,73,208,.351,29,80,.363,.481,14,18,.778,11,140,151,63,30,7,49,86,291
2017,Fred VanVleet,PG,22,TOR,37,0,294,39,111,.351,11,29,.379,28,82,.341,.401,18,22,.818,4,38,42,35,16,3,15,36,107
2017,Anderson Varejão,C,34,GSW,14,1,92,5,14,.357,0,0,,5,14,.357,.357,8,11,.727,12,15,27,10,3,3,8,16,18
2017,Greivis Vásquez,PG,30,BRK,3,0,39,2,8,.250,1,3,.333,1,5,.200,.313,2,3,.667,0,2,2,5,1,1,1,6,7
2017,Rashad Vaughn,SG,20,MIL,41,2,458,57,156,.365,26,81,.321,31,75,.413,.449,2,5,.400,4,45,49,23,19,10,14,32,142
2017,Noah Vonleh,PF,21,POR,74,41,1265,130,270,.481,7,20,.350,123,250,.492,.494,60,94,.638,131,256,387,31,30,27,64,154,327
2017,Nikola Vučević,C,26,ORL,75,55,2163,483,1031,.468,23,75,.307,460,956,.481,.480,107,160,.669,176,603,779,208,76,74,117,180,1096
2017,Sasha Vujačić,SG,32,NYK,42,4,408,42,136,.309,23,74,.311,19,62,.306,.393,17,24,.708,12,47,59,52,13,2,16,38,124
2017,Dwyane Wade,SG,35,CHI,60,59,1792,414,955,.434,45,145,.310,369,810,.456,.457,223,281,.794,63,207,270,228,86,41,138,112,1096
2017,Dion Waiters,SG,25,MIA,46,43,1384,281,663,.424,85,215,.395,196,448,.438,.488,82,127,.646,18,135,153,200,42,20,103,95,729
2017,Kemba Walker,PG,26,CHO,79,79,2739,643,1449,.444,240,602,.399,403,847,.476,.527,304,359,.847,45,263,308,434,85,22,168,119,1830
2017,John Wall,PG,26,WAS,78,78,2836,647,1435,.451,89,272,.327,558,1163,.480,.482,422,527,.801,59,267,326,831,157,49,322,151,1805
2017,T.J. Warren,SF,23,PHO,66,59,2048,403,814,.495,26,98,.265,377,716,.527,.511,119,154,.773,125,214,339,75,76,39,57,175,951
2017,C.J. Watson,PG,32,ORL,62,9,1012,96,248,.387,32,105,.305,64,143,.448,.452,57,66,.864,16,73,89,114,43,2,47,84,281
2017,Briante Weber,PG,24,TOT,20,0,205,25,60,.417,1,10,.100,24,50,.480,.425,11,16,.688,8,18,26,21,12,1,8,16,62
2017,David West,C,36,GSW,68,0,854,135,252,.536,3,8,.375,132,244,.541,.542,43,56,.768,47,156,203,151,42,48,78,105,316
2017,Russell Westbrook,PG,28,OKC,81,81,2802,824,1941,.425,200,583,.343,624,1358,.459,.476,710,840,.845,137,727,864,840,132,31,438,190,2558
2017,Okaro White,PF,24,MIA,35,0,471,33,87,.379,12,34,.353,21,53,.396,.448,20,22,.909,25,57,82,21,10,10,18,52,98
2017,Isaiah Whitehead,PG,21,BRK,73,26,1643,204,508,.402,44,149,.295,160,359,.446,.445,91,113,.805,32,152,184,192,42,36,142,175,543
2017,Hassan Whiteside,C,27,MIA,77,77,2513,542,973,.557,0,0,,542,973,.557,.557,225,358,.628,293,795,1088,57,57,161,154,226,1309
2017,Andrew Wiggins,SF,21,MIN,82,82,3048,709,1570,.452,103,289,.356,606,1281,.473,.484,412,542,.760,102,226,328,189,82,30,187,183,1933
2017,C.J. Wilcox,SG,26,ORL,22,0,108,8,31,.258,3,15,.200,5,16,.313,.306,2,2,1.000,4,8,12,12,2,1,6,8,21
2017,Alan Williams,C,24,PHO,47,0,708,138,267,.517,0,1,.000,138,266,.519,.517,70,112,.625,94,198,292,23,27,32,37,125,346
2017,Deron Williams,PG,32,TOT,64,44,1657,263,600,.438,85,234,.363,178,366,.486,.509,90,109,.826,14,133,147,360,31,8,138,138,701
2017,Derrick Williams,PF,25,TOT,50,11,804,108,244,.443,30,97,.309,78,147,.531,.504,58,89,.652,19,111,130,28,14,7,28,60,304
2017,Lou Williams,SG,30,TOT,81,1,1994,428,998,.429,163,446,.365,265,552,.480,.511,402,457,.880,26,176,202,239,80,20,160,92,1421
2017,Marvin Williams,PF,30,CHO,76,76,2295,297,704,.422,124,354,.350,173,350,.494,.510,131,150,.873,89,411,500,106,58,53,60,134,849
2017,Reggie Williams,SF,30,NOP,6,0,79,8,23,.348,5,11,.455,3,12,.250,.457,6,7,.857,2,4,6,4,3,0,0,2,27
2017,Troy Williams,SF,22,TOT,30,16,557,73,167,.437,18,62,.290,55,105,.524,.491,21,32,.656,15,54,69,25,27,10,32,60,185
2017,Kyle Wiltjer,PF,24,HOU,14,0,44,4,14,.286,4,13,.308,0,1,.000,.429,1,2,.500,4,6,10,2,3,1,5,4,13
2017,Justise Winslow,SF,20,MIA,18,15,625,80,225,.356,7,35,.200,73,190,.384,.371,29,47,.617,23,71,94,66,26,6,33,52,196
2017,Jeff Withey,C,26,UTA,51,1,432,55,103,.534,0,1,.000,55,102,.539,.534,36,48,.750,52,69,121,7,16,32,14,52,146
2017,Christian Wood,PF,21,CHO,13,0,107,12,23,.522,0,5,.000,12,18,.667,.522,11,15,.733,14,15,29,2,3,6,7,11,35
2017,Metta World Peace,SF,37,LAL,25,2,160,19,68,.279,9,38,.237,10,30,.333,.346,10,16,.625,5,15,20,11,10,2,7,18,57
2017,Brandan Wright,PF,29,MEM,28,5,447,83,135,.615,0,1,.000,83,134,.619,.615,23,35,.657,31,47,78,15,11,20,10,42,189
2017,Delon Wright,PG,24,TOR,27,0,446,49,116,.422,10,30,.333,39,86,.453,.466,42,55,.764,16,32,48,57,27,11,25,31,150
2017,James Young,SG,21,BOS,29,0,220,25,58,.431,12,35,.343,13,23,.565,.534,6,9,.667,6,20,26,4,10,2,4,15,68
2017,Joe Young,PG,24,IND,33,0,135,26,72,.361,5,23,.217,21,49,.429,.396,11,15,.733,1,16,17,15,4,0,5,5,68
2017,Nick Young,SG,31,LAL,60,60,1556,272,633,.430,170,421,.404,102,212,.481,.564,77,90,.856,25,113,138,58,37,14,36,137,791
2017,Thaddeus Young,PF,28,IND,74,74,2237,362,687,.527,45,118,.381,317,569,.557,.560,45,86,.523,131,317,448,122,113,29,95,135,814
2017,Cody Zeller,C,24,CHO,62,58,1725,253,443,.571,0,1,.000,253,442,.572,.571,133,196,.679,135,270,405,99,62,58,65,189,639
2017,Tyler Zeller,C,27,BOS,51,5,525,78,158,.494,0,1,.000,78,157,.497,.494,22,39,.564,43,81,124,42,7,21,20,61,178
2017,Stephen Zimmerman,C,20,ORL,19,0,108,10,31,.323,0,0,,10,31,.323,.323,3,5,.600,11,24,35,4,2,5,3,17,23
2017,Paul Zipser,SF,22,CHI,44,18,843,88,221,.398,33,99,.333,55,122,.451,.473,31,40,.775,15,110,125,36,15,16,40,78,240
2017,Ivica Zubac,C,19,LAL,38,11,609,126,238,.529,0,3,.000,126,235,.536,.529,32,49,.653,41,118,159,30,14,33,30,66,284
2018,Álex Abrines,SG,24,OKC,75,8,1134,115,291,.395,84,221,.380,31,70,.443,.540,39,46,.848,26,88,114,28,38,8,25,124,353
2018,Quincy Acy,PF,27,BRK,70,8,1359,130,365,.356,102,292,.349,28,73,.384,.496,49,60,.817,40,217,257,57,33,29,60,149,411
2018,Steven Adams,C,24,OKC,76,76,2487,448,712,.629,0,2,.000,448,710,.631,.629,160,286,.559,384,301,685,88,92,78,128,215,1056
2018,Bam Adebayo,C,20,MIA,69,19,1368,174,340,.512,0,7,.000,174,333,.523,.512,129,179,.721,118,263,381,101,32,41,66,138,477
2018,Arron Afflalo,SG,32,ORL,53,3,682,65,162,.401,27,70,.386,38,92,.413,.485,22,26,.846,4,62,66,30,4,9,21,56,179
2018,Cole Aldrich,C,29,MIN,21,0,49,5,15,.333,0,0,,5,15,.333,.333,2,6,.333,3,12,15,3,2,1,1,11,12
2018,LaMarcus Aldridge,C,32,SAS,75,75,2509,687,1347,.510,27,92,.293,660,1255,.526,.520,334,399,.837,246,389,635,152,43,90,111,161,1735
2018,Jarrett Allen,C,19,BRK,72,31,1441,234,397,.589,5,15,.333,229,382,.599,.596,114,147,.776,144,244,388,49,28,88,82,147,587
2018,Kadeem Allen,PG,25,BOS,18,1,107,6,22,.273,0,11,.000,6,11,.545,.273,7,9,.778,4,7,11,12,3,2,9,15,19
2018,Tony Allen,SF,36,NOP,22,0,273,44,91,.484,4,12,.333,40,79,.506,.505,11,21,.524,20,27,47,9,11,3,19,49,103
2018,Al-Farouq Aminu,PF,27,POR,69,67,2072,230,582,.395,125,339,.369,105,243,.432,.503,59,80,.738,97,428,525,84,79,40,79,136,644
2018,Justin Anderson,SF,24,PHI,38,0,519,87,202,.431,34,103,.330,53,99,.535,.515,28,38,.737,25,68,93,25,15,7,16,54,236
2018,Kyle Anderson,SF,24,SAS,74,67,1978,231,438,.527,19,57,.333,212,381,.556,.549,104,146,.712,84,312,396,202,115,60,94,114,585
2018,Ryan Anderson,PF,29,HOU,66,50,1725,207,480,.431,131,339,.386,76,141,.539,.568,72,93,.774,94,237,331,60,24,21,42,126,617
2018,Ike Anigbogu,C,19,IND,11,0,30,4,9,.444,0,0,,4,9,.444,.444,5,6,.833,5,4,9,0,1,3,2,1,13
2018,Giannis Antetokounmpo,PF,23,MIL,75,75,2756,742,1402,.529,43,140,.307,699,1262,.554,.545,487,641,.760,156,597,753,361,109,106,223,231,2014
2018,Carmelo Anthony,PF,33,OKC,78,78,2501,472,1168,.404,169,474,.357,303,694,.437,.476,148,193,.767,67,386,453,103,47,49,99,197,1261
2018,OG Anunoby,SF,20,TOR,74,62,1481,163,346,.471,73,197,.371,90,149,.604,.577,39,62,.629,44,140,184,55,52,14,45,130,438
2018,Ryan Arcidiacono,PG,23,CHI,24,0,304,17,41,.415,9,31,.290,8,10,.800,.524,5,6,.833,1,24,25,35,13,0,13,18,48
2018,Trevor Ariza,SF,32,HOU,67,67,2269,268,651,.412,170,462,.368,98,189,.519,.542,76,89,.854,33,261,294,105,98,13,52,132,782
2018,Darrell Arthur,PF,29,DEN,19,1,141,22,47,.468,8,23,.348,14,24,.583,.553,2,3,.667,3,12,15,9,8,3,15,22,54
2018,Jamel Artis,SG,25,ORL,15,1,279,31,79,.392,8,29,.276,23,50,.460,.443,7,12,.583,4,34,38,18,2,3,8,11,77
2018,Ömer Aşık,C,31,TOT,18,0,182,9,22,.409,0,0,,9,22,.409,.409,4,13,.308,9,38,47,3,2,4,9,20,22
2018,D.J. Augustin,PG,30,ORL,75,36,1760,244,540,.452,114,272,.419,130,268,.485,.557,164,189,.868,30,130,160,287,54,0,123,94,766
2018,Luke Babbitt,SF,28,TOT,50,14,715,91,215,.423,60,156,.385,31,59,.525,.563,17,22,.773,7,89,96,31,8,7,19,54,259
2018,Dwayne Bacon,SG,22,CHO,53,6,713,72,192,.375,11,43,.256,61,149,.409,.404,20,25,.800,4,120,124,38,16,2,23,46,175
2018,Ron Baker,SG,24,NYK,29,1,385,20,59,.339,11,33,.333,9,26,.346,.432,20,26,.769,5,25,30,47,26,6,18,33,71
2018,Wade Baldwin,PG,21,POR,7,0,80,14,21,.667,4,5,.800,10,16,.625,.762,6,10,.600,1,7,8,5,2,1,4,12,38
2018,Lonzo Ball,PG,20,LAL,52,50,1780,203,564,.360,90,295,.305,113,269,.420,.440,32,71,.451,69,291,360,376,88,43,136,117,528
2018,J.J. Barea,PG,33,DAL,69,10,1603,303,690,.439,115,313,.367,188,377,.499,.522,80,102,.784,15,186,201,434,35,3,143,83,801
2018,Harrison Barnes,PF,25,DAL,77,77,2634,537,1208,.445,119,333,.357,418,875,.478,.494,259,313,.827,77,391,468,152,49,14,118,94,1452
2018,Will Barton,SG,27,DEN,81,40,2683,465,1028,.452,156,422,.370,309,606,.510,.528,182,226,.805,70,339,409,331,82,52,149,168,1268
2018,Nicolas Batum,SG,29,CHO,64,64,1981,270,650,.415,92,274,.336,178,376,.473,.486,108,130,.831,57,249,306,349,65,23,131,72,740
2018,Jerryd Bayless,SG,29,PHI,39,11,925,109,262,.416,54,146,.370,55,116,.474,.519,35,44,.795,15,65,80,54,23,6,46,91,307
2018,Aron Baynes,C,31,BOS,81,67,1485,210,446,.471,3,21,.143,207,425,.487,.474,59,78,.756,130,304,434,93,22,51,80,200,482
2018,Kent Bazemore,SG,28,ATL,65,65,1789,284,676,.420,108,274,.394,176,402,.438,.500,160,201,.796,25,223,248,228,100,45,157,147,836
2018,Bradley Beal,SG,24,WAS,82,82,2977,683,1484,.460,199,530,.375,484,954,.507,.527,292,369,.791,61,302,363,373,96,36,214,160,1857
2018,Malik Beasley,SG,21,DEN,62,0,583,73,178,.410,28,82,.341,45,96,.469,.489,22,33,.667,14,57,71,31,15,7,24,36,196
2018,Michael Beasley,PF,29,NYK,74,30,1653,409,807,.507,34,86,.395,375,721,.520,.528,124,159,.780,97,317,414,123,36,43,143,145,976
2018,Marco Belinelli,SG,31,TOT,80,2,1947,337,764,.441,149,395,.377,188,369,.509,.539,148,163,.908,20,131,151,148,66,12,94,91,971
2018,Jordan Bell,C,23,GSW,57,13,809,116,185,.627,0,4,.000,116,181,.641,.627,30,44,.682,60,147,207,102,35,56,51,92,262
2018,DeAndre' Bembry,SF,23,ATL,26,3,455,53,128,.414,11,30,.367,42,98,.429,.457,19,33,.576,8,64,72,49,21,12,47,38,136
2018,Dragan Bender,PF,20,PHO,82,37,2069,187,484,.386,118,322,.366,69,162,.426,.508,39,51,.765,40,321,361,130,22,53,112,166,531
2018,Dāvis Bertāns,PF,25,SAS,77,10,1086,161,366,.440,94,252,.373,67,114,.588,.568,40,49,.816,18,135,153,74,26,28,36,93,456
2018,Patrick Beverley,SG,29,LAC,11,11,334,48,119,.403,24,60,.400,24,59,.407,.504,14,17,.824,16,29,45,32,19,5,25,34,134
2018,Khem Birch,C,25,ORL,42,0,578,68,126,.540,0,0,,68,126,.540,.540,42,61,.689,70,110,180,34,15,21,21,56,178
2018,Jabari Bird,SG,23,BOS,13,1,115,15,26,.577,3,7,.429,12,19,.632,.635,6,13,.462,6,13,19,8,3,1,8,7,39
2018,Bismack Biyombo,C,25,ORL,82,25,1495,183,352,.520,0,1,.000,183,351,.521,.520,102,157,.650,144,324,468,66,21,95,84,158,468
2018,Nemanja Bjelica,PF,29,MIN,67,21,1371,171,371,.461,76,183,.415,95,188,.505,.563,36,45,.800,53,221,274,86,50,16,52,141,454
2018,Tarik Black,C,26,HOU,51,2,536,75,127,.591,1,11,.091,74,116,.638,.594,29,63,.460,63,100,163,13,21,30,35,107,180
2018,Antonio Blakeney,SG,21,CHI,19,0,314,53,143,.371,15,52,.288,38,91,.418,.423,30,39,.769,4,29,33,20,7,1,11,19,151
2018,Eric Bledsoe,PG,28,TOT,74,74,2322,468,989,.473,125,360,.347,343,629,.545,.536,252,317,.795,51,233,284,370,149,42,216,185,1313
2018,Vander Blue,SG,25,LAL,5,0,45,1,5,.200,0,2,.000,1,3,.333,.200,1,2,.500,0,1,1,3,1,0,3,2,3
2018,Bogdan Bogdanović,SG,25,SAC,78,53,2175,344,772,.446,129,329,.392,215,443,.485,.529,100,119,.840,31,192,223,258,72,16,125,172,917
2018,Bojan Bogdanović,SF,28,IND,80,80,2464,404,852,.474,155,386,.402,249,466,.534,.565,178,205,.868,30,240,270,119,55,8,106,129,1141
2018,Andrew Bogut,C,33,LAL,24,5,216,17,25,.680,0,0,,17,25,.680,.680,2,2,1.000,26,52,78,15,4,13,19,40,36
2018,Joel Bolomboy,PF,24,MIL,6,0,38,3,6,.500,0,1,.000,3,5,.600,.500,3,6,.500,6,4,10,0,2,0,2,3,9
2018,Devin Booker,SG,21,PHO,54,54,1865,455,1054,.432,147,384,.383,308,670,.460,.501,289,329,.878,26,218,244,253,47,14,194,168,1346
2018,Trevor Booker,PF,30,TOT,68,7,1158,177,343,.516,8,33,.242,169,310,.545,.528,66,93,.710,117,201,318,82,28,21,59,119,428
2018,Chris Boucher,PF,25,GSW,1,0,1,0,1,.000,0,1,.000,0,0,,.000,0,0,,0,1,1,0,0,0,0,0,0
2018,Avery Bradley,SG,27,TOT,46,46,1433,259,625,.414,75,203,.369,184,422,.436,.474,63,82,.768,22,94,116,94,51,8,101,92,656
2018,Tony Bradley,C,20,UTA,9,0,29,3,11,.273,0,1,.000,3,10,.300,.273,2,2,1.000,4,7,11,1,0,0,0,1,8
2018,Corey Brewer,SF-SG,31,TOT,72,18,1208,142,316,.449,31,110,.282,111,206,.539,.498,65,90,.722,43,111,154,65,79,14,49,139,380
2018,Malcolm Brogdon,PG,25,MIL,48,20,1436,244,503,.485,62,161,.385,182,342,.532,.547,75,85,.882,23,133,156,152,41,13,66,128,625
2018,Aaron Brooks,PG,33,MIN,32,1,189,28,69,.406,11,31,.355,17,38,.447,.486,8,11,.727,7,10,17,20,6,0,11,28,75
2018,Dillon Brooks,SF,22,MEM,82,74,2350,340,772,.440,94,264,.356,246,508,.484,.501,124,166,.747,49,208,257,135,73,17,124,233,898
2018,MarShon Brooks,SG,29,MEM,7,1,193,51,102,.500,19,32,.594,32,70,.457,.593,20,23,.870,8,13,21,25,11,3,16,6,141
2018,Anthony Brown,SF,25,MIN,1,0,4,1,1,1.000,1,1,1.000,0,0,,1.500,0,0,,0,0,0,1,0,0,0,0,3
2018,Bobby Brown,PG,33,HOU,20,0,115,19,58,.328,11,40,.275,8,18,.444,.422,1,2,.500,0,7,7,11,4,0,9,6,50
2018,Jaylen Brown,SG,21,BOS,70,70,2152,373,803,.465,121,306,.395,252,497,.507,.540,150,233,.644,66,280,346,114,70,26,124,181,1017
2018,Lorenzo Brown,PG,27,TOR,14,0,139,14,34,.412,2,12,.167,12,22,.545,.441,2,2,1.000,1,14,15,13,5,0,3,7,32
2018,Markel Brown,SG,26,HOU,4,0,31,2,7,.286,1,5,.200,1,2,.500,.357,0,0,,1,4,5,2,0,0,2,6,5
2018,Sterling Brown,SG,22,MIL,54,4,776,82,205,.400,32,91,.352,50,114,.439,.478,21,24,.875,27,116,143,25,31,13,25,80,217
2018,Nicolás Brussino,SF,24,ATL,4,0,10,0,2,.000,0,2,.000,0,0,,.000,0,0,,0,3,3,0,0,0,0,0,0
2018,Thomas Bryant,C,20,LAL,15,0,72,8,21,.381,1,10,.100,7,11,.636,.405,5,9,.556,3,14,17,6,1,2,2,6,22
2018,Reggie Bullock,SF,26,DET,62,52,1732,267,546,.489,125,281,.445,142,265,.536,.603,39,49,.796,27,127,154,95,47,13,47,70,698
2018,Trey Burke,PG,25,NYK,36,9,785,193,384,.503,38,105,.362,155,279,.556,.552,37,57,.649,13,58,71,170,24,4,43,43,461
2018,Alec Burks,SG,26,UTA,64,1,1059,170,414,.411,47,142,.331,123,272,.452,.467,107,124,.863,19,173,192,67,37,8,60,75,494
2018,Jimmy Butler,SG,28,MIN,59,59,2164,437,921,.474,70,200,.350,367,721,.509,.512,363,425,.854,79,235,314,288,116,24,108,78,1307
2018,Dwight Buycks,PG,28,DET,29,0,427,82,198,.414,15,45,.333,67,153,.438,.452,36,41,.878,12,29,41,59,19,2,39,39,215
2018,Bruno Caboclo,SF,22,TOT,12,0,107,9,31,.290,3,17,.176,6,14,.429,.339,5,6,.833,7,15,22,4,3,4,4,8,26
2018,José Calderón,PG,36,CLE,57,32,914,93,185,.503,45,97,.464,48,88,.545,.624,24,30,.800,14,70,84,117,27,2,41,81,255
2018,Kentavious Caldwell-Pope,SG,24,LAL,74,74,2458,340,798,.426,159,415,.383,181,383,.473,.526,153,194,.789,60,327,387,162,106,16,97,145,992
2018,Isaiah Canaan,PG-SG,26,TOT,20,1,422,52,137,.380,22,66,.333,30,71,.423,.460,46,51,.902,6,39,45,76,16,1,29,36,172
2018,Clint Capela,C,23,HOU,74,74,2034,441,676,.652,0,1,.000,441,675,.653,.652,144,257,.560,241,561,802,68,58,137,103,185,1026
2018,DeMarre Carroll,PF,31,BRK,73,73,2180,325,785,.414,145,391,.371,180,394,.457,.506,188,246,.764,105,374,479,147,59,30,103,165,983
2018,Vince Carter,SF,41,SAC,58,5,1026,114,283,.403,57,165,.345,57,118,.483,.504,28,37,.757,18,130,148,69,42,26,36,96,313
2018,Michael Carter-Williams,PG,26,CHO,52,2,835,76,229,.332,14,59,.237,62,170,.365,.362,73,89,.820,37,101,138,116,44,23,52,99,239
2018,Alex Caruso,PG,23,LAL,37,7,562,50,116,.431,13,43,.302,37,73,.507,.487,21,30,.700,15,50,65,75,23,10,42,52,134
2018,Omri Casspi,SF,29,GSW,53,7,740,120,207,.580,10,22,.455,110,185,.595,.604,50,69,.725,30,170,200,51,18,19,37,71,300
2018,Willie Cauley-Stein,C,24,SAC,73,58,2044,388,773,.502,3,12,.250,385,761,.506,.504,153,247,.619,131,379,510,172,77,67,109,185,932
2018,Tyler Cavanaugh,PF,23,ATL,39,1,518,67,152,.441,32,89,.360,35,63,.556,.546,17,21,.810,45,82,127,27,9,4,14,61,183
2018,Mario Chalmers,PG,31,MEM,66,10,1421,168,443,.379,53,191,.277,115,252,.456,.439,118,138,.855,13,144,157,197,79,14,117,179,507
2018,Tyson Chandler,C,35,PHO,46,46,1151,121,187,.647,0,0,,121,187,.647,.647,58,93,.624,134,284,418,53,16,27,59,106,300
2018,Wilson Chandler,SF,30,DEN,74,71,2346,281,631,.445,88,246,.358,193,385,.501,.515,88,114,.772,102,296,398,159,43,39,92,156,738
2018,Marquese Chriss,PF,20,PHO,72,49,1527,202,477,.423,56,190,.295,146,287,.509,.482,96,158,.608,76,319,395,83,51,70,107,205,556
2018,Ian Clark,SG,26,NOP,74,2,1455,222,495,.448,62,195,.318,160,300,.533,.511,45,59,.763,10,117,127,110,33,10,57,120,551
2018,Jordan Clarkson,SG,25,TOT,81,2,1888,430,954,.451,112,318,.352,318,636,.500,.509,152,190,.800,57,160,217,221,58,6,127,107,1124
2018,Gian Clavell,SG,24,DAL,7,0,64,6,18,.333,6,15,.400,0,3,.000,.500,2,2,1.000,1,6,7,3,2,0,2,8,20
2018,Antonius Cleveland,SG,23,TOT,17,0,123,8,21,.381,3,4,.750,5,17,.294,.452,4,6,.667,3,11,14,2,7,5,7,23,23
2018,John Collins,PF,20,ATL,74,26,1785,314,545,.576,16,47,.340,298,498,.598,.591,133,186,.715,176,365,541,98,47,80,105,215,777
2018,Zach Collins,C,20,POR,66,1,1045,115,289,.398,35,113,.310,80,176,.455,.458,27,42,.643,45,176,221,52,17,31,58,133,292
2018,Kyle Collinsworth,SF,26,DAL,32,2,480,38,99,.384,4,17,.235,34,82,.415,.404,21,40,.525,32,75,107,56,17,9,24,44,101
2018,Darren Collison,PG,30,IND,69,64,2018,316,638,.495,96,205,.468,220,433,.508,.571,127,144,.882,37,141,178,368,92,15,86,122,855
2018,Nick Collison,PF,37,OKC,15,0,75,13,19,.684,0,0,,13,19,.684,.684,5,13,.385,7,13,20,4,0,0,7,7,31
2018,Mike Conley,PG,30,MEM,12,12,373,64,168,.381,24,77,.312,40,91,.440,.452,53,66,.803,0,27,27,49,12,3,18,24,205
2018,Pat Connaughton,SG,25,POR,82,5,1488,165,390,.423,74,210,.352,91,180,.506,.518,37,44,.841,36,125,161,91,23,22,43,120,441
2018,Quinn Cook,PG,24,GSW,33,18,740,122,252,.484,46,104,.442,76,148,.514,.575,22,25,.880,10,72,82,89,12,1,32,59,312
2018,Charles Cooke,SG,23,NOP,13,0,38,2,14,.143,1,8,.125,1,6,.167,.179,1,2,.500,0,2,2,1,1,0,1,0,6
2018,Jack Cooley,PF,26,SAC,7,0,87,13,27,.481,0,0,,13,27,.481,.481,14,19,.737,14,16,30,6,1,0,3,13,40
2018,Matt Costello,C,24,SAS,4,0,32,2,4,.500,0,0,,2,4,.500,.500,0,0,,1,8,9,2,2,2,1,7,4
2018,DeMarcus Cousins,C,27,NOP,48,48,1737,406,864,.470,104,294,.354,302,570,.530,.530,294,394,.746,105,512,617,257,79,76,242,183,1210
2018,Robert Covington,SF,27,PHI,80,80,2532,345,836,.413,203,550,.369,142,286,.497,.534,116,136,.853,55,378,433,156,137,72,126,238,1009
2018,Allen Crabbe,SG,25,BRK,75,68,2197,337,827,.407,201,532,.378,136,295,.461,.529,115,135,.852,28,296,324,117,47,35,78,168,990
2018,Torrey Craig,SF,27,DEN,39,5,629,62,137,.453,17,58,.293,45,79,.570,.515,22,35,.629,40,87,127,25,12,15,20,63,163
2018,Jamal Crawford,SG,37,MIN,80,0,1653,308,742,.415,104,314,.331,204,428,.477,.485,102,113,.903,21,78,99,185,40,9,95,85,822
2018,Jordan Crawford,SG,29,NOP,5,0,53,12,27,.444,8,14,.571,4,13,.308,.593,1,1,1.000,2,2,4,13,1,1,5,7,33
2018,Jae Crowder,SF,27,TOT,80,47,2090,271,671,.404,110,341,.323,161,330,.488,.486,121,148,.818,59,216,275,99,64,21,74,187,773
2018,Dante Cunningham,SF,30,TOT,73,25,1562,164,364,.451,58,168,.345,106,196,.541,.530,31,52,.596,78,220,298,48,39,30,33,111,417
2018,Stephen Curry,PG,29,GSW,51,51,1631,428,864,.495,212,501,.423,216,363,.595,.618,278,302,.921,36,225,261,310,80,8,153,114,1346
2018,Troy Daniels,SG,26,PHO,79,15,1622,232,575,.403,183,458,.400,49,117,.419,.563,56,64,.875,12,115,127,48,26,5,56,137,703
2018,Anthony Davis,PF,24,NOP,75,75,2727,780,1462,.534,55,162,.340,725,1300,.558,.552,495,598,.828,187,645,832,174,115,193,162,159,2110
2018,Deyonta Davis,C,21,MEM,62,6,943,161,265,.608,0,0,,161,265,.608,.608,38,57,.667,75,175,250,40,15,39,32,125,360
2018,Ed Davis,C,28,POR,78,0,1471,170,292,.582,0,1,.000,170,291,.584,.582,74,111,.667,183,392,575,40,32,52,66,188,414
2018,Dewayne Dedmon,C,28,ATL,62,46,1542,250,477,.524,50,141,.355,200,336,.595,.577,67,86,.779,100,389,489,90,40,51,86,162,617
2018,Sam Dekker,PF,23,LAC,73,1,883,128,259,.494,10,60,.167,118,199,.593,.514,37,56,.661,44,130,174,38,24,9,33,71,303
2018,Malcolm Delaney,PG,28,ATL,54,3,1014,109,285,.382,46,124,.371,63,161,.391,.463,74,92,.804,9,91,100,163,35,6,66,82,338
2018,Matthew Dellavedova,PG,27,MIL,38,3,712,55,152,.362,29,78,.372,26,74,.351,.457,25,27,.926,14,50,64,145,14,0,49,67,164
2018,Luol Deng,SF,32,LAL,1,1,13,1,2,.500,0,0,,1,2,.500,.500,0,0,,0,0,0,1,1,0,1,0,2
2018,DeMar DeRozan,SG,28,TOR,80,80,2711,645,1413,.456,89,287,.310,556,1126,.494,.488,461,559,.825,59,256,315,417,85,22,175,151,1840
2018,Cheick Diallo,PF,21,NOP,52,0,581,102,176,.580,0,0,,102,176,.580,.580,50,66,.758,47,164,211,19,11,21,28,82,254
2018,Gorgui Dieng,C,28,MIN,79,0,1333,186,388,.479,19,61,.311,167,327,.511,.504,79,102,.775,106,254,360,71,45,39,59,147,470
2018,Spencer Dinwiddie,PG,24,BRK,80,58,2306,324,838,.387,141,433,.326,183,405,.452,.471,218,268,.813,40,219,259,524,68,23,128,186,1007
2018,Tyler Dorsey,SG,21,ATL,56,5,974,144,382,.377,72,199,.362,72,183,.393,.471,45,63,.714,17,113,130,79,17,5,37,63,405
2018,Damyean Dotson,SG,23,NYK,44,2,474,72,161,.447,22,68,.324,50,93,.538,.516,16,23,.696,9,75,84,31,12,2,17,34,182
2018,Milton Doyle,SG,24,BRK,10,0,125,13,47,.277,4,23,.174,9,24,.375,.319,4,8,.500,3,15,18,10,6,2,2,13,34
2018,PJ Dozier,PG,21,OKC,2,0,3,1,2,.500,0,0,,1,2,.500,.500,0,0,,0,1,1,0,0,0,1,1,2
2018,Goran Dragić,PG,31,MIA,75,75,2378,484,1075,.450,111,300,.370,373,775,.481,.502,217,271,.801,54,252,306,359,63,12,166,180,1296
2018,Larry Drew II,PG,27,TOT,10,0,70,7,24,.292,3,9,.333,4,15,.267,.354,0,0,,3,0,3,10,0,0,3,6,17
2018,Andre Drummond,C,24,DET,78,78,2625,466,881,.529,0,11,.000,466,870,.536,.529,239,395,.605,399,848,1247,237,114,127,200,250,1171
2018,Jared Dudley,PF,32,PHO,48,0,686,48,122,.393,29,80,.363,19,42,.452,.512,27,35,.771,8,86,94,78,24,11,28,85,152
2018,Kris Dunn,PG,23,CHI,52,43,1525,286,666,.429,43,134,.321,243,532,.457,.462,84,114,.737,24,197,221,310,104,27,150,174,699
2018,Kevin Durant,SF,29,GSW,68,68,2325,630,1222,.516,173,413,.419,457,809,.565,.586,359,404,.889,31,433,464,366,50,119,207,133,1792
2018,Jarell Eddie,SF,26,TOT,3,0,9,0,2,.000,0,2,.000,0,0,,.000,0,0,,0,1,1,0,1,0,0,0,0
2018,Henry Ellenson,PF,21,DET,38,0,329,53,146,.363,20,60,.333,33,86,.384,.432,25,29,.862,10,71,81,20,5,0,18,22,151
2018,Wayne Ellington,SG,30,MIA,77,2,2041,285,700,.407,227,579,.392,58,121,.479,.569,67,78,.859,23,195,218,79,53,8,52,94,864
2018,Joel Embiid,C,23,PHI,63,63,1912,510,1056,.483,66,214,.308,444,842,.527,.514,359,467,.769,143,547,690,199,40,111,234,209,1445
2018,James Ennis III,SF,27,TOT,72,22,1604,182,384,.474,51,153,.333,131,231,.567,.540,97,116,.836,73,151,224,71,47,18,56,134,512
2018,Tyler Ennis,PG,23,LAL,54,11,683,94,224,.420,14,56,.250,80,168,.476,.451,22,29,.759,19,76,95,105,30,10,38,75,224
2018,Jawun Evans,PG,21,LAC,48,4,778,89,253,.352,15,54,.278,74,199,.372,.381,38,49,.776,9,75,84,100,36,6,44,97,231
2018,Jeremy Evans,SF,30,ATL,1,0,5,1,1,1.000,0,0,,1,1,1.000,1.000,0,0,,1,0,1,0,0,0,1,1,2
2018,Tyreke Evans,PG,28,MEM,52,32,1607,366,809,.452,114,286,.399,252,523,.482,.523,164,209,.785,44,221,265,269,57,17,117,96,1010
2018,Dante Exum,PG,22,UTA,14,0,235,42,87,.483,5,18,.278,37,69,.536,.511,25,31,.806,4,22,26,43,8,3,20,20,114
2018,Kenneth Faried,PF,28,DEN,32,7,461,76,148,.514,0,1,.000,76,147,.517,.514,36,51,.706,68,85,153,18,12,13,23,51,188
2018,Derrick Favors,C,26,UTA,77,77,2153,395,702,.563,14,63,.222,381,639,.596,.573,140,215,.651,198,354,552,102,54,82,88,164,944
2018,Kay Felder,PG,22,TOT,16,0,140,21,70,.300,4,19,.211,17,51,.333,.329,11,12,.917,3,15,18,20,3,1,16,11,57
2018,Cristiano Felício,C,25,CHI,55,16,977,127,215,.591,0,2,.000,127,213,.596,.591,54,81,.667,83,150,233,55,16,11,54,104,308
2018,Raymond Felton,PG,33,OKC,82,2,1365,224,552,.406,81,230,.352,143,322,.444,.479,36,44,.818,25,131,156,203,49,16,76,91,565
2018,Terrance Ferguson,SG,19,OKC,61,12,763,70,169,.414,40,120,.333,30,49,.612,.533,9,10,.900,19,28,47,19,24,10,11,83,189
2018,Yogi Ferrell,SG,24,DAL,82,21,2282,311,730,.426,134,359,.373,177,371,.477,.518,82,103,.796,26,223,249,201,64,9,78,153,838
2018,Dorian Finney-Smith,PF,24,DAL,21,13,448,46,121,.380,20,67,.299,26,54,.481,.463,11,15,.733,22,53,75,26,10,4,21,43,123
2018,Bryn Forbes,SG,24,SAS,80,12,1517,209,497,.421,89,228,.390,120,269,.446,.510,48,72,.667,12,98,110,80,28,2,37,108,555
2018,Evan Fournier,SF,25,ORL,57,57,1837,368,802,.459,127,335,.379,241,467,.516,.538,150,173,.867,23,157,180,165,47,16,95,138,1013
2018,De'Aaron Fox,PG,20,SAC,73,60,2026,328,797,.412,47,153,.307,281,644,.436,.441,141,195,.723,33,171,204,320,70,20,173,163,844
2018,Tim Frazier,PG,27,WAS,59,11,838,68,172,.395,17,56,.304,51,116,.440,.445,23,30,.767,18,97,115,194,47,7,57,97,176
2018,Enes Freedom,C,25,NYK,71,71,1830,422,713,.592,0,2,.000,422,711,.594,.592,156,184,.848,273,507,780,105,36,37,122,187,1000
2018,Channing Frye,C,34,TOT,53,1,695,104,212,.491,39,115,.339,65,97,.670,.583,17,19,.895,12,123,135,38,18,13,21,69,264
2018,Markelle Fultz,SG,19,PHI,14,0,253,45,111,.405,0,1,.000,45,110,.409,.405,10,21,.476,11,32,43,53,12,4,17,22,100
2018,Danilo Gallinari,SF,29,LAC,21,21,671,102,256,.398,36,111,.324,66,145,.455,.469,81,87,.931,9,92,101,41,12,10,26,30,321
2018,Langston Galloway,SG,26,DET,58,2,863,126,340,.371,75,218,.344,51,122,.418,.481,33,41,.805,13,79,92,58,35,5,18,39,360
2018,Marc Gasol,C,33,MEM,73,73,2408,434,1033,.420,109,320,.341,325,713,.456,.473,281,337,.834,78,514,592,305,54,101,194,185,1258
2018,Pau Gasol,C,37,SAS,77,63,1812,287,627,.458,43,120,.358,244,507,.481,.492,158,209,.756,129,490,619,238,24,79,108,121,775
2018,Rudy Gay,PF,31,SAS,57,6,1231,253,537,.471,37,118,.314,216,419,.516,.506,112,145,.772,76,215,291,73,46,38,78,98,655
2018,Paul George,SF,27,OKC,79,79,2891,576,1340,.430,244,609,.401,332,731,.454,.521,338,411,.822,72,375,447,263,161,39,212,233,1734
2018,Marcus Georges-Hunt,SG,23,MIN,42,0,224,21,48,.438,4,15,.267,17,33,.515,.479,13,21,.619,7,9,16,7,6,0,3,32,59
2018,Jonathan Gibson,PG,30,BOS,4,0,40,14,23,.609,6,12,.500,8,11,.727,.739,0,0,,0,3,3,4,0,0,3,5,34
2018,Taj Gibson,PF,32,MIN,82,82,2726,425,737,.577,7,35,.200,418,702,.595,.581,142,185,.768,194,390,584,99,62,59,89,218,999
2018,Manu Ginóbili,SG,40,SAS,65,0,1299,201,463,.434,64,192,.333,137,271,.506,.503,110,131,.840,19,123,142,163,43,16,105,126,576
2018,Rudy Gobert,C,25,UTA,56,56,1816,276,444,.622,0,0,,276,444,.622,.622,204,299,.682,165,436,601,80,44,129,107,153,756
2018,Aaron Gordon,PF,22,ORL,58,57,1909,375,865,.434,115,342,.336,260,523,.497,.500,157,225,.698,87,370,457,136,59,45,107,111,1022
2018,Eric Gordon,SG,29,HOU,69,30,2154,415,970,.428,218,608,.359,197,362,.544,.540,195,241,.809,25,145,170,154,44,27,130,116,1243
2018,Marcin Gortat,C,33,WAS,82,82,2075,290,560,.518,0,0,,290,560,.518,.518,110,163,.675,181,442,623,151,40,61,99,175,690
2018,Treveon Graham,SG,24,CHO,63,2,1050,96,221,.434,40,97,.412,56,124,.452,.525,41,59,.695,42,79,121,59,33,2,27,109,273
2018,Jerami Grant,PF,23,OKC,81,1,1647,244,456,.535,32,110,.291,212,346,.613,.570,162,240,.675,86,233,319,57,31,77,54,155,682
2018,Jerian Grant,PG,25,CHI,74,26,1686,209,503,.416,61,187,.326,148,316,.468,.476,140,188,.745,31,141,172,342,63,8,89,132,619
2018,Josh Gray,PG,24,PHO,5,0,86,11,41,.268,3,13,.231,8,28,.286,.305,7,11,.636,2,8,10,12,8,2,7,8,32
2018,Danny Green,SG,30,SAS,70,60,1791,217,561,.387,116,320,.363,101,241,.419,.490,50,65,.769,41,208,249,110,63,80,74,122,600
2018,Draymond Green,PF,27,GSW,70,70,2287,281,619,.454,77,256,.301,204,363,.562,.516,134,173,.775,75,460,535,508,95,91,202,185,773
2018,Gerald Green,SG,32,HOU,41,2,929,168,413,.407,110,298,.369,58,115,.504,.540,51,60,.850,15,118,133,25,24,15,31,87,497
2018,JaMychal Green,PF,27,MEM,55,54,1542,223,488,.457,43,127,.339,180,361,.499,.501,80,111,.721,147,317,464,79,32,25,76,153,569
2018,Jeff Green,PF,31,CLE,78,13,1828,295,618,.477,53,170,.312,242,448,.540,.520,203,234,.868,60,186,246,99,41,34,75,149,846
2018,Blake Griffin,PF,28,TOT,58,58,1970,436,996,.438,111,322,.345,325,674,.482,.493,259,330,.785,73,355,428,334,41,18,165,139,1242
2018,Daniel Hamilton,SG,22,OKC,6,0,28,5,11,.455,2,5,.400,3,6,.500,.545,0,0,,0,5,5,8,1,0,2,2,12
2018,Tim Hardaway Jr.,SG,25,NYK,57,54,1885,360,856,.421,130,410,.317,230,446,.516,.496,146,179,.816,32,192,224,155,62,10,92,123,996
2018,James Harden,SG,28,HOU,72,72,2551,651,1449,.449,265,722,.367,386,727,.531,.541,624,727,.858,41,348,389,630,126,50,315,169,2191
2018,Maurice Harkless,SF,24,POR,59,36,1264,147,297,.495,49,118,.415,98,179,.547,.577,42,59,.712,46,116,162,53,48,43,40,103,385
2018,Montrezl Harrell,C,24,LAC,76,3,1293,348,548,.635,1,7,.143,347,541,.641,.636,139,222,.626,103,203,306,74,36,52,68,143,836
2018,Devin Harris,PG,34,TOT,71,1,1340,187,454,.412,79,227,.348,108,227,.476,.499,142,170,.835,12,115,127,152,47,12,76,158,595
2018,Gary Harris,SG,23,DEN,67,65,2304,440,908,.485,156,394,.396,284,514,.553,.570,134,162,.827,37,139,176,194,122,15,119,119,1170
2018,Joe Harris,SG,26,BRK,78,14,1975,305,621,.491,150,358,.419,155,263,.589,.612,86,104,.827,51,209,260,128,35,20,91,153,846
2018,Tobias Harris,PF,25,TOT,80,80,2668,562,1221,.460,183,445,.411,379,776,.488,.535,179,216,.829,58,379,437,192,71,35,105,164,1486
2018,Aaron Harrison,SG,23,DAL,9,3,233,19,69,.275,9,43,.209,10,26,.385,.341,13,17,.765,4,20,24,11,9,2,3,27,60
2018,Andrew Harrison,PG,23,MEM,56,46,1326,181,429,.422,47,142,.331,134,287,.467,.477,124,159,.780,23,108,131,177,38,26,81,138,533
2018,Shaquille Harrison,PG,24,PHO,23,2,384,59,124,.476,6,26,.231,53,98,.541,.500,28,38,.737,9,52,61,55,26,7,22,42,152
2018,Josh Hart,SG,22,LAL,63,23,1461,176,375,.469,78,197,.396,98,178,.551,.573,66,94,.702,42,221,263,80,47,16,47,107,496
2018,Udonis Haslem,C,37,MIA,14,0,72,3,15,.200,1,8,.125,2,7,.286,.233,1,2,.500,3,7,10,5,0,2,2,3,8
2018,Nigel Hayes,SF,23,TOT,9,0,122,11,33,.333,4,16,.250,7,17,.412,.394,1,3,.333,4,18,22,6,2,3,2,8,27
2018,Gordon Hayward,SF,27,BOS,1,1,5,1,2,.500,0,1,.000,1,1,1.000,.500,0,0,,0,1,1,0,0,0,0,1,2
2018,Reggie Hearn,SG,26,DET,3,0,7,1,2,.500,1,2,.500,0,0,,.750,0,0,,0,0,0,0,0,0,0,0,3
2018,Myke Henry,SF,25,MEM,20,0,378,41,109,.376,19,58,.328,22,51,.431,.463,6,10,.600,10,28,38,22,31,6,19,28,107
2018,John Henson,C,27,MIL,76,69,1970,287,502,.572,1,7,.143,286,495,.578,.573,90,158,.570,150,363,513,114,45,109,84,202,665
2018,Juancho Hernangómez,PF,22,DEN,25,3,277,29,75,.387,14,50,.280,15,25,.600,.480,10,12,.833,18,36,54,12,6,3,9,25,82
2018,Willy Hernangómez,C,23,TOT,48,1,495,91,164,.555,5,12,.417,86,152,.566,.570,59,90,.656,61,122,183,33,18,16,35,64,246
2018,Mario Hezonja,SF,22,ORL,75,30,1657,273,617,.442,90,267,.337,183,350,.523,.515,86,105,.819,41,240,281,106,81,31,86,134,722
2018,Isaiah Hicks,PF,23,NYK,18,0,240,33,72,.458,2,9,.222,31,63,.492,.472,12,18,.667,10,31,41,16,2,4,16,45,80
2018,Buddy Hield,SG,25,SAC,80,12,2024,416,933,.446,176,408,.431,240,525,.457,.540,71,81,.877,55,252,307,155,85,22,124,148,1079
2018,Nenê,C,35,HOU,52,4,758,136,239,.569,0,2,.000,136,237,.574,.569,68,107,.636,54,122,176,45,28,14,38,123,340
2018,George Hill,PG,31,TOT,67,60,1812,236,513,.460,85,205,.415,151,308,.490,.543,110,140,.786,42,139,181,186,61,27,88,128,667
2018,Solomon Hill,SF,26,NOP,12,1,187,11,41,.268,4,21,.190,7,20,.350,.317,3,6,.500,9,27,36,22,7,1,9,22,29
2018,Darrun Hilliard,SG,24,SAS,14,0,95,5,19,.263,0,6,.000,5,13,.385,.263,6,7,.857,0,7,7,11,2,0,4,7,16
2018,Jrue Holiday,SG,27,NOP,81,81,2927,615,1244,.494,120,356,.337,495,888,.557,.543,187,238,.786,62,303,365,486,123,64,213,201,1537
2018,Justin Holiday,SG,28,CHI,72,72,2265,290,782,.371,161,449,.359,129,333,.387,.474,135,164,.823,31,260,291,153,80,31,93,134,876
2018,John Holland,SF,29,CLE,24,0,174,17,59,.288,11,36,.306,6,23,.261,.381,9,13,.692,6,18,24,5,7,2,8,10,54
2018,Rondae Hollis-Jefferson,SF,23,BRK,68,59,1920,342,724,.472,13,54,.241,329,670,.491,.481,249,316,.788,101,358,459,167,65,48,121,145,946
2018,Richaun Holmes,C,24,PHI,48,2,746,135,241,.560,4,31,.129,131,210,.624,.568,37,56,.661,57,154,211,61,20,29,25,97,311
2018,Rodney Hood,SG,25,TOT,60,23,1616,322,751,.429,127,333,.381,195,418,.467,.513,111,129,.860,22,143,165,95,45,12,70,105,882
2018,Scotty Hopson,SG,28,DAL,1,0,8,0,1,.000,0,0,,0,1,.000,.000,1,2,.500,0,0,0,1,0,0,1,0,1
2018,Al Horford,C,31,BOS,72,72,2277,368,753,.489,97,226,.429,271,527,.514,.553,94,120,.783,103,427,530,339,43,78,132,138,927
2018,Danuel House Jr.,SG,24,PHO,23,3,403,56,129,.434,15,58,.259,41,71,.577,.492,25,31,.806,13,63,76,25,7,6,11,23,152
2018,Dwight Howard,C,32,CHO,81,81,2463,506,911,.555,1,7,.143,505,904,.559,.556,334,582,.574,255,757,1012,105,48,131,208,249,1347
2018,Josh Huestis,PF,26,OKC,69,10,982,60,182,.330,33,115,.287,27,67,.403,.420,6,20,.300,42,119,161,20,15,43,26,82,159
2018,R.J. Hunter,SG,24,HOU,5,1,45,7,20,.350,3,14,.214,4,6,.667,.425,2,2,1.000,0,5,5,3,3,0,2,7,19
2018,Vince Hunter,PF,23,MEM,4,0,7,3,5,.600,0,0,,3,5,.600,.600,0,0,,2,1,3,0,0,1,1,0,6
2018,Serge Ibaka,PF,28,TOR,76,76,2093,379,784,.483,107,297,.360,272,487,.559,.552,94,118,.797,78,400,478,62,29,99,90,209,959
2018,Andre Iguodala,SF,34,GSW,64,7,1622,148,320,.463,33,117,.282,115,203,.567,.514,55,87,.632,50,196,246,210,54,38,67,99,384
2018,Ersan İlyasova,PF,30,TOT,69,43,1729,277,613,.452,91,253,.360,186,360,.517,.526,105,135,.778,118,287,405,90,61,26,72,157,750
2018,Joe Ingles,SF,30,UTA,82,81,2578,335,718,.467,204,464,.440,131,254,.516,.609,66,83,.795,24,320,344,392,90,20,159,178,940
2018,Andre Ingram,SG,32,LAL,2,0,64,8,17,.471,5,9,.556,3,8,.375,.618,3,3,1.000,1,5,6,7,3,3,3,3,24
2018,Brandon Ingram,SF,20,LAL,59,59,1975,358,761,.470,41,105,.390,317,656,.483,.497,192,282,.681,57,257,314,230,45,43,149,163,949
2018,Kyrie Irving,PG,25,BOS,60,60,1931,534,1087,.491,166,407,.408,368,680,.541,.568,232,261,.889,33,194,227,306,65,17,140,122,1466
2018,Jonathan Isaac,PF,20,ORL,27,10,536,55,145,.379,16,46,.348,39,99,.394,.434,19,25,.760,16,83,99,18,33,30,27,48,145
2018,Wes Iwundu,SF,23,ORL,62,12,1020,93,218,.427,9,46,.196,84,172,.488,.447,34,47,.723,36,101,137,57,33,12,30,81,229
2018,Jarrett Jack,PG,34,NYK,62,56,1548,189,443,.427,25,86,.291,164,357,.459,.455,63,75,.840,22,169,191,348,35,4,115,98,466
2018,Aaron Jackson,PG,31,HOU,1,0,35,3,9,.333,1,4,.250,2,5,.400,.389,1,2,.500,2,1,3,1,0,0,1,4,8
2018,Demetrius Jackson,PG,23,TOT,15,0,80,7,18,.389,1,7,.143,6,11,.545,.417,1,2,.500,5,7,12,9,5,1,10,7,16
2018,Josh Jackson,SF,20,PHO,77,35,1959,389,932,.417,57,217,.263,332,715,.464,.448,177,279,.634,95,256,351,119,80,35,146,218,1012
2018,Justin Jackson,SF,22,SAC,68,41,1506,185,419,.442,57,185,.308,128,234,.547,.510,26,36,.722,27,160,187,74,28,13,40,81,453
2018,Reggie Jackson,PG,27,DET,45,45,1201,246,577,.426,52,169,.308,194,408,.475,.471,112,134,.836,29,96,125,238,27,4,99,87,656
2018,LeBron James,PF,33,CLE,82,82,3026,857,1580,.542,149,406,.367,708,1174,.603,.590,388,531,.731,97,612,709,747,116,71,347,136,2251
2018,Mike James,PG,27,TOT,36,10,687,123,321,.383,26,98,.265,97,223,.435,.424,64,84,.762,13,77,90,126,28,7,49,48,336
2018,Al Jefferson,C,33,IND,36,1,484,111,208,.534,0,3,.000,111,205,.541,.534,30,36,.833,30,113,143,30,16,23,21,66,252
2018,Richard Jefferson,SF,37,DEN,20,0,163,12,27,.444,2,7,.286,10,20,.500,.481,4,7,.571,2,15,17,15,2,1,5,11,30
2018,Brandon Jennings,PG,28,MIL,14,0,205,27,72,.375,9,33,.273,18,39,.462,.438,10,10,1.000,5,26,31,44,6,4,18,11,73
2018,Jonas Jerebko,PF,30,UTA,74,19,1134,159,341,.466,65,157,.414,94,184,.511,.562,46,57,.807,53,193,246,42,24,12,27,127,429
2018,Amir Johnson,C,30,PHI,74,18,1171,140,260,.538,10,32,.313,130,228,.570,.558,52,85,.612,123,207,330,118,45,44,55,192,342
2018,Brice Johnson,PF,23,TOT,18,0,98,20,42,.476,0,1,.000,20,41,.488,.476,3,5,.600,9,22,31,2,9,6,5,13,43
2018,Dakari Johnson,C,22,OKC,31,6,161,22,39,.564,0,0,,22,39,.564,.564,11,20,.550,16,18,34,8,6,8,3,27,55
2018,James Johnson,PF,30,MIA,73,41,1943,309,614,.503,57,185,.308,252,429,.587,.550,113,162,.698,61,297,358,280,70,51,141,192,788
2018,Joe Johnson,SF,36,TOT,55,4,1205,146,360,.406,40,145,.276,106,215,.493,.461,40,45,.889,14,158,172,83,18,7,49,67,372
2018,Omari Johnson,PF,28,MEM,4,0,75,9,21,.429,4,12,.333,5,9,.556,.524,0,0,,4,7,11,7,2,0,3,6,22
2018,Stanley Johnson,SF,21,DET,69,50,1894,210,560,.375,67,234,.286,143,326,.439,.435,112,145,.772,33,219,252,112,95,14,77,169,599
2018,Tyler Johnson,PG,25,MIA,72,39,2052,309,711,.435,119,324,.367,190,387,.491,.518,106,129,.822,34,214,248,165,60,34,81,148,843
2018,Wesley Johnson,SF,30,LAC,74,40,1486,150,368,.408,60,177,.339,90,191,.471,.489,43,58,.741,29,187,216,61,76,62,55,146,403
2018,Nikola Jokić,C,22,DEN,75,73,2443,504,1010,.499,111,280,.396,393,730,.538,.554,266,313,.850,195,608,803,458,90,61,210,212,1385
2018,Damian Jones,C,22,GSW,15,0,89,11,22,.500,0,0,,11,22,.500,.500,3,5,.600,5,9,14,2,1,3,4,14,25
2018,Derrick Jones Jr.,SF,20,TOT,20,8,245,21,53,.396,3,18,.167,18,35,.514,.425,16,24,.667,21,17,38,9,4,13,7,24,61
2018,Jalen Jones,SF,24,TOT,16,0,181,26,68,.382,10,26,.385,16,42,.381,.456,12,19,.632,13,25,38,4,5,1,7,22,74
2018,Tyus Jones,PG,21,MIN,82,11,1467,150,328,.457,45,129,.349,105,199,.528,.526,71,81,.877,16,116,132,232,95,6,59,110,416
2018,DeAndre Jordan,C,29,LAC,77,77,2424,373,578,.645,0,0,,373,578,.645,.645,181,312,.580,329,842,1171,117,39,71,137,203,927
2018,Cory Joseph,PG,26,IND,82,17,2210,256,604,.424,67,190,.353,189,414,.457,.479,70,94,.745,39,224,263,260,80,18,87,141,649
2018,Frank Kaminsky,PF,24,CHO,79,4,1835,307,716,.429,104,274,.380,203,442,.459,.501,155,194,.799,46,242,288,129,36,19,66,95,873
2018,Luke Kennard,SG,21,DET,73,9,1463,206,465,.443,81,195,.415,125,270,.463,.530,65,76,.855,21,155,176,124,44,13,69,86,558
2018,Michael Kidd-Gilchrist,SF,24,CHO,74,74,1850,282,560,.504,0,2,.000,282,558,.505,.504,117,171,.684,84,218,302,71,51,32,53,143,681
2018,Sean Kilpatrick,SG,28,TOT,52,1,640,110,294,.374,46,144,.319,64,150,.427,.452,64,72,.889,5,82,87,46,13,5,38,33,330
2018,Maxi Kleber,PF,26,DAL,72,36,1206,151,309,.489,40,128,.313,111,181,.613,.553,44,59,.746,71,163,234,51,26,47,30,114,386
2018,Furkan Korkmaz,SG,20,PHI,14,0,80,8,28,.286,5,17,.294,3,11,.273,.375,2,4,.500,2,9,11,4,2,1,2,12,23
2018,Luke Kornet,PF,22,NYK,20,1,326,49,125,.392,28,79,.354,21,46,.457,.504,8,11,.727,11,53,64,26,6,16,12,28,134
2018,Kyle Korver,SG,36,CLE,73,4,1574,222,484,.459,164,376,.436,58,108,.537,.628,64,72,.889,9,156,165,88,31,27,55,130,672
2018,Kosta Koufos,C,28,SAC,71,13,1391,222,389,.571,0,0,,222,389,.571,.571,33,74,.446,149,323,472,87,47,32,49,146,477
2018,Kyle Kuzma,PF,22,LAL,77,37,2401,468,1039,.450,159,434,.366,309,605,.511,.527,147,208,.707,88,395,483,141,49,34,140,160,1242
2018,Mindaugas Kuzminskas,SF,28,NYK,1,0,2,0,2,.000,0,0,,0,2,.000,.000,0,0,,0,0,0,0,0,0,0,0,0
2018,Skal Labissière,PF,21,SAC,60,28,1240,205,458,.448,18,51,.353,187,407,.459,.467,95,118,.805,99,189,288,72,25,49,73,132,523
2018,Jeremy Lamb,SG,25,CHO,80,18,1967,380,832,.457,94,254,.370,286,578,.495,.513,179,208,.861,49,275,324,186,61,32,93,138,1033
2018,Shane Larkin,PG,25,BOS,54,2,775,84,219,.384,31,86,.360,53,133,.398,.454,32,37,.865,15,77,92,98,29,2,33,58,231
2018,Joffrey Lauvergne,C,26,SAS,55,1,534,98,190,.516,0,5,.000,98,185,.530,.516,30,47,.638,63,108,171,41,9,3,33,45,226
2018,Zach LaVine,SG,22,CHI,24,24,656,136,355,.383,42,123,.341,94,232,.405,.442,87,107,.813,9,85,94,72,24,4,43,55,401
2018,Jake Layman,SF,23,POR,35,1,160,14,47,.298,4,20,.200,10,27,.370,.340,2,3,.667,4,12,16,11,6,4,5,13,34
2018,T.J. Leaf,PF,20,IND,53,0,459,64,136,.471,18,42,.429,46,94,.489,.537,10,16,.625,29,53,82,9,5,4,10,45,156
2018,Courtney Lee,SG,32,NYK,76,69,2310,343,755,.454,113,278,.406,230,477,.482,.529,114,124,.919,30,194,224,180,80,17,84,109,913
2018,Damion Lee,SG,25,ATL,15,11,404,62,152,.408,15,60,.250,47,92,.511,.457,22,29,.759,11,60,71,29,19,1,14,25,161
2018,Walt Lemon Jr.,PG,25,NOP,5,0,35,7,16,.438,1,1,1.000,6,15,.400,.469,2,3,.667,0,2,2,5,0,1,4,5,17
2018,Alex Len,C,24,PHO,69,13,1395,214,378,.566,1,3,.333,213,375,.568,.567,158,231,.684,175,343,518,82,27,61,78,158,587
2018,Kawhi Leonard,SF,26,SAS,9,9,210,52,111,.468,11,35,.314,41,76,.539,.518,31,38,.816,6,36,42,21,18,9,16,9,146
2018,Meyers Leonard,C,25,POR,33,2,254,46,78,.590,11,26,.423,35,52,.673,.660,9,11,.818,12,58,70,17,7,0,10,36,112
2018,Jon Leuer,PF,28,DET,8,0,136,15,36,.417,0,3,.000,15,33,.455,.417,13,15,.867,7,25,32,5,1,3,7,16,43
2018,Caris LeVert,SF,23,BRK,71,10,1864,320,735,.435,85,245,.347,235,490,.480,.493,133,187,.711,53,207,260,299,82,22,153,159,858
2018,DeAndre Liggins,SG,29,TOT,58,4,724,40,106,.377,19,53,.358,21,53,.396,.467,2,5,.400,7,68,75,48,37,14,20,81,101
2018,Damian Lillard,PG,27,POR,73,73,2670,621,1415,.439,227,629,.361,394,786,.501,.519,493,538,.916,62,263,325,481,77,27,206,117,1962
2018,Jeremy Lin,PG,29,BRK,1,1,25,5,12,.417,1,2,.500,4,10,.400,.458,7,7,1.000,0,0,0,4,0,0,3,3,18
2018,Shaun Livingston,PG,32,GSW,71,7,1129,172,343,.501,0,5,.000,172,338,.509,.501,50,61,.820,32,99,131,140,35,21,58,117,394
2018,Kevon Looney,C,21,GSW,66,4,910,112,193,.580,1,5,.200,111,188,.590,.583,42,77,.545,83,132,215,42,34,56,31,106,267
2018,Brook Lopez,C,29,LAL,74,72,1735,369,793,.465,112,325,.345,257,468,.549,.536,111,158,.703,74,220,294,126,30,98,98,195,961
2018,Robin Lopez,C,29,CHI,64,64,1690,342,645,.530,4,14,.286,338,631,.536,.533,68,90,.756,134,156,290,124,14,53,107,109,756
2018,Kevin Love,C,29,CLE,59,59,1651,334,729,.458,137,330,.415,197,399,.494,.552,234,266,.880,101,445,546,103,43,24,90,120,1039
2018,Kyle Lowry,PG,31,TOR,78,78,2510,403,944,.427,238,596,.399,165,348,.474,.553,223,261,.854,66,368,434,537,85,19,183,192,1267
2018,Timothé Luwawu-Cabarrot,SF,22,PHI,52,7,807,100,267,.375,53,158,.335,47,109,.431,.474,46,58,.793,14,58,72,54,12,5,38,97,299
2018,Tyler Lydon,PF,21,DEN,1,0,2,0,0,,0,0,,0,0,,,0,0,,0,0,0,0,0,0,0,0,0
2018,Trey Lyles,PF,22,DEN,73,2,1391,270,550,.491,83,218,.381,187,332,.563,.566,101,143,.706,55,292,347,91,30,34,61,111,724
2018,Shelvin Mack,PG,27,ORL,69,3,1365,178,414,.430,48,139,.345,130,275,.473,.488,69,97,.711,23,143,166,272,54,8,89,91,473
2018,Josh Magette,PG,28,ATL,18,0,216,15,46,.326,8,22,.364,7,24,.292,.413,8,8,1.000,2,17,19,57,8,1,9,16,46
2018,Ian Mahinmi,C,31,WAS,77,0,1145,138,248,.556,0,2,.000,138,246,.561,.556,90,128,.703,135,177,312,53,38,42,100,230,366
2018,Thon Maker,C,20,MIL,74,12,1238,130,316,.411,31,104,.298,99,212,.467,.460,65,93,.699,75,150,225,46,38,53,44,162,356
2018,Boban Marjanović,C,29,TOT,39,1,337,79,148,.534,0,0,,79,148,.534,.534,77,97,.794,48,96,144,22,10,11,36,51,235
2018,Lauri Markkanen,PF,20,CHI,68,68,2020,374,862,.434,145,401,.362,229,461,.497,.518,140,166,.843,79,429,508,79,39,40,83,103,1033
2018,Jarell Martin,PF,23,MEM,73,36,1661,221,496,.446,34,98,.347,187,398,.470,.480,89,116,.767,97,221,318,73,39,49,86,211,565
2018,Frank Mason III,PG,23,SAC,52,2,984,144,380,.379,31,86,.360,113,294,.384,.420,94,115,.817,30,100,130,147,34,10,65,72,413
2018,Mangok Mathiang,C,25,CHO,4,0,20,4,7,.571,0,0,,4,7,.571,.571,0,1,.000,3,7,10,0,1,0,0,5,8
2018,Wesley Matthews,SF,31,DAL,63,62,2131,283,697,.406,153,402,.381,130,295,.441,.516,83,101,.822,28,170,198,172,76,16,83,140,802
2018,Luc Mbah a Moute,PF,31,HOU,61,15,1564,166,345,.481,63,173,.364,103,172,.599,.572,65,95,.684,22,164,186,55,72,25,68,100,460
2018,James Michael McAdoo,PF,25,PHI,3,0,18,2,7,.286,2,7,.286,0,0,,.429,2,2,1.000,0,2,2,0,0,1,1,1,8
2018,Patrick McCaw,SG,22,GSW,57,10,961,92,225,.409,19,80,.238,73,145,.503,.451,26,34,.765,16,66,82,81,43,10,41,67,229
2018,CJ McCollum,SG,26,POR,81,81,2923,667,1505,.443,189,476,.397,478,1029,.465,.506,209,250,.836,53,268,321,272,77,35,151,168,1732
2018,T.J. McConnell,PG,25,PHI,76,1,1706,210,421,.499,27,62,.435,183,359,.510,.531,31,39,.795,37,189,226,303,92,13,112,122,478
2018,Erik McCree,SF,24,UTA,4,0,8,0,2,.000,0,1,.000,0,1,.000,.000,0,0,,0,1,1,0,1,0,1,0,0
2018,Chris McCullough,PF,22,WAS,19,0,90,18,42,.429,1,8,.125,17,34,.500,.440,9,14,.643,7,18,25,4,0,5,2,8,46
2018,Doug McDermott,SF,26,TOT,81,4,1768,237,508,.467,92,216,.426,145,292,.497,.557,64,81,.790,40,160,200,79,19,16,56,122,630
2018,JaVale McGee,C,30,GSW,65,17,615,136,219,.621,0,6,.000,136,213,.638,.621,38,52,.731,59,110,169,33,21,57,27,91,310
2018,Rodney McGruder,SG,26,MIA,18,2,299,36,73,.493,15,35,.429,21,38,.553,.596,4,8,.500,11,22,33,17,8,3,4,21,91
2018,Trey McKinney-Jones,SG,27,IND,1,0,1,0,0,,0,0,,0,0,,,0,0,,0,0,0,0,0,0,0,0,0
2018,Alfonzo McKinnie,SF,25,TOR,14,0,53,8,15,.533,3,9,.333,5,6,.833,.633,2,3,.667,1,6,7,1,1,1,3,8,21
2018,Ben McLemore,SG,24,MEM,56,17,1091,157,373,.421,55,159,.346,102,214,.477,.495,53,64,.828,34,105,139,51,38,15,61,139,422
2018,Josh McRoberts,PF,30,DAL,2,0,6,0,1,.000,0,1,.000,0,0,,.000,0,0,,0,0,0,0,0,0,0,2,0
2018,Jodie Meeks,SG,30,WAS,77,0,1119,157,393,.399,72,210,.343,85,183,.464,.491,101,117,.863,15,111,126,70,29,4,37,55,487
2018,Salah Mejri,C,31,DAL,61,1,729,88,137,.642,0,3,.000,88,134,.657,.642,38,66,.576,85,161,246,35,22,67,39,121,214
2018,Jordan Mickey,PF,23,MIA,23,3,284,39,82,.476,2,16,.125,37,66,.561,.488,13,19,.684,18,63,81,9,6,10,18,36,93
2018,Khris Middleton,SF,26,MIL,82,82,2982,593,1272,.466,146,407,.359,447,865,.517,.524,320,362,.884,45,384,429,328,119,21,191,270,1652
2018,C.J. Miles,SF,30,TOR,70,3,1337,227,599,.379,164,454,.361,63,145,.434,.516,81,97,.835,18,134,152,55,37,21,39,134,699
2018,Darius Miller,SF,27,NOP,82,3,1944,216,487,.444,147,358,.411,69,129,.535,.594,58,67,.866,18,146,164,111,28,17,58,160,637
2018,Malcolm Miller,SF,24,TOR,15,4,126,13,28,.464,8,21,.381,5,7,.714,.607,4,4,1.000,4,11,15,3,1,2,5,10,38
2018,Patty Mills,PG,29,SAS,82,36,2107,280,682,.411,154,414,.372,126,268,.470,.523,105,118,.890,26,128,154,229,55,11,106,128,819
2018,Paul Millsap,PF,32,DEN,38,37,1143,202,435,.464,39,113,.345,163,322,.506,.509,112,161,.696,65,180,245,105,39,44,73,99,555
2018,Nikola Mirotić,PF,26,TOT,55,14,1494,306,684,.447,135,358,.377,171,326,.525,.546,112,137,.818,59,346,405,80,44,39,62,108,859
2018,Donovan Mitchell,SG,21,UTA,79,71,2638,595,1362,.437,187,550,.340,408,812,.502,.506,239,297,.805,52,244,296,291,118,27,215,213,1616
2018,Naz Mitrou-Long,SG,24,UTA,1,0,1,1,1,1.000,1,1,1.000,0,0,,1.500,0,0,,0,0,0,0,0,0,0,0,3
2018,Malik Monk,SG,19,CHO,63,0,854,153,425,.360,83,243,.342,70,182,.385,.458,32,38,.842,8,58,66,91,20,9,49,60,421
2018,Greg Monroe,C,27,TOT,51,14,1040,218,386,.565,0,0,,218,386,.565,.565,88,119,.739,109,241,350,114,44,23,94,95,524
2018,Luis Montero,SG,24,DET,2,0,8,0,1,.000,0,0,,0,1,.000,.000,0,0,,0,2,2,0,0,0,2,0,0
2018,Ben Moore,PF,22,IND,2,0,9,0,0,,0,0,,0,0,,,0,0,,0,1,1,1,0,0,0,4,0
2018,E'Twaun Moore,SG,28,NOP,82,80,2586,423,832,.508,128,301,.425,295,531,.556,.585,48,68,.706,57,181,238,187,79,12,102,182,1022
2018,Eric Moreland,PF,26,DET,67,3,805,66,122,.541,0,0,,66,122,.541,.541,11,29,.379,81,197,278,78,31,51,42,116,143
2018,Jaylen Morris,SG,22,ATL,6,0,98,13,32,.406,2,10,.200,11,22,.500,.438,0,0,,2,14,16,7,2,1,6,2,28
2018,Marcus Morris,PF,28,BOS,54,21,1442,262,611,.429,86,234,.368,176,377,.467,.499,124,154,.805,43,246,289,72,35,12,65,100,734
2018,Markieff Morris,PF,28,WAS,73,73,1968,330,687,.480,76,207,.367,254,480,.529,.536,105,128,.820,75,334,409,142,56,38,127,216,841
2018,Monte Morris,PG,22,DEN,3,0,25,4,6,.667,0,1,.000,4,5,.800,.667,2,2,1.000,0,2,2,7,3,0,1,1,10
2018,Johnathan Motley,PF,22,DAL,11,4,176,40,75,.533,1,6,.167,39,69,.565,.540,15,28,.536,14,35,49,7,3,2,9,18,96
2018,Timofey Mozgov,C,31,BRK,31,13,359,52,93,.559,4,18,.222,48,75,.640,.581,23,30,.767,32,66,98,11,5,13,33,39,131
2018,Emmanuel Mudiay,PG,21,TOT,64,14,1245,204,526,.388,47,148,.318,157,378,.415,.433,98,129,.760,26,126,152,206,41,11,113,80,553
2018,Shabazz Muhammad,SF-SG,25,TOT,43,2,418,84,188,.447,7,27,.259,77,161,.478,.465,39,50,.780,23,53,76,14,9,3,6,30,214
2018,Xavier Munford,SG,25,MIL,6,0,21,1,6,.167,0,2,.000,1,4,.250,.167,1,2,.500,1,0,1,4,1,0,2,4,3
2018,Dejounte Murray,PG,21,SAS,81,48,1743,270,609,.443,9,34,.265,261,575,.454,.451,105,148,.709,110,349,459,231,97,31,134,151,654
2018,Jamal Murray,PG,20,DEN,81,80,2565,479,1062,.451,165,436,.378,314,626,.502,.529,229,253,.905,82,215,297,274,79,28,172,173,1352
2018,Mike Muscala,C,26,ATL,53,7,1060,143,312,.458,62,167,.371,81,145,.559,.558,57,62,.919,56,174,230,51,31,27,42,80,405
2018,Abdel Nader,SF,24,BOS,48,1,522,50,149,.336,23,65,.354,27,84,.321,.413,23,39,.590,13,58,71,26,15,10,34,45,146
2018,Larry Nance Jr.,C,25,TOT,66,27,1421,240,413,.581,2,12,.167,238,401,.594,.584,91,137,.664,161,291,452,82,88,38,51,172,573
2018,Shabazz Napier,PG,26,POR,74,10,1535,223,531,.420,82,218,.376,141,313,.450,.497,116,138,.841,26,144,170,150,81,14,90,84,644
2018,Jameer Nelson,PG,35,TOT,50,0,1013,95,244,.389,41,124,.331,54,120,.450,.473,16,20,.800,13,91,104,179,27,4,67,81,247
2018,Raul Neto,PG,25,UTA,41,0,498,69,151,.457,19,47,.404,50,104,.481,.520,26,35,.743,7,42,49,75,13,4,36,38,183
2018,Georges Niang,PF,24,UTA,9,0,32,4,11,.364,0,4,.000,4,7,.571,.364,1,2,.500,3,6,9,3,2,0,3,1,9
2018,Joakim Noah,C,32,NYK,7,0,40,5,10,.500,0,0,,5,10,.500,.500,2,4,.500,6,8,14,4,2,2,4,5,12
2018,Nerlens Noel,C,23,DAL,30,6,472,55,105,.524,0,1,.000,55,104,.529,.524,21,28,.750,48,120,168,20,31,22,26,59,131
2018,Lucas Nogueira,C,25,TOR,49,3,418,49,80,.613,5,19,.263,44,61,.721,.644,19,28,.679,18,69,87,22,23,43,16,49,122
2018,Dirk Nowitzki,C,39,DAL,77,77,1900,346,758,.456,138,337,.409,208,421,.494,.547,97,108,.898,22,416,438,120,43,45,51,146,927
2018,Frank Ntilikina,PG,19,NYK,78,9,1706,182,500,.364,50,157,.318,132,343,.385,.414,49,68,.721,37,140,177,250,65,18,131,181,463
2018,Jusuf Nurkić,C,23,POR,79,79,2088,480,951,.505,0,7,.000,480,944,.508,.505,172,273,.630,189,519,708,143,64,111,183,247,1132
2018,David Nwaba,SG,25,CHI,70,21,1646,202,423,.478,18,52,.346,184,371,.496,.499,133,203,.655,89,237,326,104,59,29,77,158,555
2018,Johnny O'Bryant,PF,24,CHO,36,0,379,68,171,.398,14,43,.326,54,128,.422,.439,21,25,.840,29,64,93,14,9,6,15,45,171
2018,Royce O'Neale,SF,24,UTA,69,4,1150,120,284,.423,42,118,.356,78,166,.470,.496,61,76,.803,25,211,236,95,36,16,55,105,343
2018,Kyle O'Quinn,C,27,NYK,77,10,1387,224,384,.583,4,17,.235,220,367,.599,.589,98,127,.772,121,349,470,158,36,98,100,192,550
2018,Semi Ojeleye,PF,23,BOS,73,0,1150,65,188,.346,40,125,.320,25,63,.397,.452,25,41,.610,37,124,161,20,21,4,25,91,195
2018,Emeka Okafor,C,35,NOP,26,19,353,48,95,.505,0,0,,48,95,.505,.505,18,22,.818,47,73,120,8,8,25,13,30,114
2018,Jahlil Okafor,C,22,TOT,28,0,353,77,138,.558,1,4,.250,76,134,.567,.562,21,29,.724,21,64,85,12,3,18,21,51,176
2018,Victor Oladipo,SG,25,IND,75,75,2552,640,1342,.477,161,434,.371,479,908,.528,.537,294,368,.799,47,343,390,323,177,57,219,175,1735
2018,Kelly Olynyk,PF,26,MIA,76,22,1779,316,636,.497,106,280,.379,210,356,.590,.580,134,174,.770,89,342,431,207,62,35,147,222,872
2018,Chinanu Onuaku,C,21,HOU,1,0,22,2,5,.400,0,0,,2,5,.400,.400,0,0,,1,3,4,1,0,0,3,4,4
2018,Cedi Osman,SF,22,CLE,61,12,672,90,186,.484,32,87,.368,58,99,.586,.570,26,46,.565,19,101,120,41,22,3,32,78,238
2018,Kelly Oubre Jr.,SF,22,WAS,81,11,2231,318,790,.403,126,369,.341,192,421,.456,.482,191,233,.820,59,304,363,98,80,35,90,234,953
2018,Zaza Pachulia,C,33,GSW,69,57,972,149,264,.564,0,1,.000,149,263,.567,.564,75,93,.806,89,232,321,109,38,17,72,122,373
2018,Marcus Paige,PG,24,CHO,5,0,28,4,14,.286,2,8,.250,2,6,.333,.357,2,2,1.000,0,4,4,3,0,0,0,0,12
2018,Georgios Papagiannis,C,20,TOT,17,0,122,18,42,.429,0,0,,18,42,.429,.429,0,0,,13,24,37,9,4,6,8,12,36
2018,Jabari Parker,PF,22,MIL,31,3,743,160,332,.482,31,81,.383,129,251,.514,.529,40,54,.741,42,109,151,59,25,10,45,50,391
2018,Tony Parker,PG,35,SAS,55,21,1071,178,388,.459,10,37,.270,168,351,.479,.472,55,78,.705,7,88,95,195,28,1,68,52,421
2018,Chandler Parsons,SF,29,MEM,36,8,691,108,234,.462,51,121,.421,57,113,.504,.571,17,27,.630,14,76,90,69,18,11,35,53,284
2018,Patrick Patterson,PF,28,OKC,82,3,1270,106,266,.398,66,171,.386,40,95,.421,.523,40,46,.870,32,161,193,57,48,23,33,87,318
2018,Justin Patton,C,20,MIN,1,0,4,1,2,.500,0,0,,1,2,.500,.500,0,0,,0,0,0,0,1,0,0,1,2
2018,Brandon Paul,SG,26,SAS,64,2,576,55,127,.433,15,54,.278,40,73,.548,.492,22,43,.512,6,62,68,37,25,7,29,58,147
2018,Chris Paul,PG,32,HOU,58,58,1847,367,798,.460,144,379,.380,223,419,.532,.550,203,221,.919,37,276,313,457,96,14,128,141,1081
2018,Adreian Payne,PF,26,ORL,5,0,43,7,10,.700,2,3,.667,5,7,.714,.800,5,6,.833,2,7,9,0,2,0,2,6,21
2018,Cameron Payne,PG,23,CHI,25,14,582,87,215,.405,35,91,.385,52,124,.419,.486,12,16,.750,18,51,69,113,26,9,36,44,221
2018,Elfrid Payton,PG,23,TOT,63,63,1808,329,667,.493,30,92,.326,299,575,.520,.516,109,168,.649,64,210,274,393,83,22,168,147,797
2018,Gary Payton II,PG,25,TOT,23,6,221,30,74,.405,6,25,.240,24,49,.490,.446,3,9,.333,13,31,44,21,7,3,7,30,69
2018,Kendrick Perkins,C,33,CLE,1,0,15,1,2,.500,0,0,,1,2,.500,.500,1,2,.500,0,1,1,2,1,0,1,1,3
2018,London Perrantes,PG,23,CLE,14,0,66,2,13,.154,0,3,.000,2,10,.200,.154,3,5,.600,1,3,4,5,2,1,1,6,7
2018,Alec Peters,PF,22,PHO,20,0,225,28,74,.378,18,58,.310,10,16,.625,.500,8,10,.800,8,29,37,12,2,2,4,13,82
2018,Marshall Plumlee,C,25,MIL,8,0,52,1,3,.333,0,0,,1,3,.333,.333,12,16,.750,4,13,17,2,0,1,3,10,14
2018,Mason Plumlee,C,27,DEN,74,26,1439,221,368,.601,0,1,.000,221,367,.602,.601,82,179,.458,132,268,400,142,49,81,103,184,524
2018,Miles Plumlee,C,29,ATL,55,35,918,105,180,.583,0,0,,105,180,.583,.583,27,60,.450,77,151,228,45,17,30,63,79,237
2018,Jakob Poeltl,C,22,TOR,82,0,1524,253,384,.659,1,2,.500,252,382,.660,.660,60,101,.594,165,228,393,57,39,100,85,212,567
2018,Quincy Pondexter,SF,29,CHI,23,1,196,14,49,.286,3,22,.136,11,27,.407,.316,14,17,.824,8,19,27,9,8,2,11,24,45
2018,Otto Porter Jr.,SF,24,WAS,77,77,2432,445,885,.503,138,313,.441,307,572,.537,.581,106,128,.828,103,389,492,157,116,41,75,151,1134
2018,Bobby Portis,PF,22,CHI,73,4,1643,382,811,.471,80,223,.359,302,588,.514,.520,120,156,.769,159,339,498,123,50,23,103,130,964
2018,Kristaps Porziņģis,PF,22,NYK,48,48,1553,390,889,.439,90,228,.395,300,661,.454,.489,218,275,.793,62,254,316,57,36,115,93,141,1088
2018,Dwight Powell,C,26,DAL,79,25,1672,255,430,.593,28,84,.333,227,346,.656,.626,133,185,.719,135,309,444,91,67,32,59,186,671
2018,Norman Powell,SG,24,TOR,70,18,1062,150,374,.401,53,186,.285,97,188,.516,.472,32,39,.821,14,105,119,89,37,16,66,111,385
2018,Alex Poythress,PF,24,IND,25,0,104,11,26,.423,4,11,.364,7,15,.467,.500,0,0,,7,10,17,2,3,1,2,16,26
2018,Taurean Prince,SF,23,ATL,82,82,2464,415,975,.426,176,457,.385,239,518,.461,.516,152,180,.844,50,339,389,214,85,42,191,168,1158
2018,Jacob Pullen,PG,28,PHI,3,0,6,1,2,.500,0,1,.000,1,1,1.000,.500,0,0,,0,0,0,0,0,0,1,0,2
2018,Rodney Purvis,SG,23,ORL,16,2,290,35,107,.327,13,52,.250,22,55,.400,.388,13,15,.867,1,26,27,17,3,3,10,26,96
2018,Zhou Qi,C,22,HOU,18,0,124,6,32,.188,2,19,.105,4,13,.308,.219,8,12,.667,6,16,22,2,2,14,10,14,22
2018,Tim Quarterman,SG,23,HOU,3,0,13,1,3,.333,0,2,.000,1,1,1.000,.333,2,2,1.000,0,3,3,1,0,0,2,1,4
2018,Ivan Rabb,PF,20,MEM,36,5,516,86,152,.566,0,0,,86,152,.566,.566,29,36,.806,53,105,158,32,12,13,35,55,201
2018,Julius Randle,C,23,LAL,82,49,2190,504,904,.558,10,45,.222,494,859,.575,.563,305,425,.718,181,473,654,210,43,45,213,274,1323
2018,Zach Randolph,PF,36,SAC,59,57,1508,361,763,.473,51,147,.347,310,616,.503,.507,84,107,.785,97,300,397,127,42,10,116,119,857
2018,Xavier Rathan-Mayes,SG,23,MEM,5,0,118,12,42,.286,1,14,.071,11,28,.393,.298,4,9,.444,0,5,5,18,6,3,11,18,29
2018,J.J. Redick,SG,33,PHI,70,70,2116,404,879,.460,193,460,.420,211,419,.504,.569,197,218,.904,9,169,178,210,35,6,103,123,1198
2018,Davon Reed,SG,22,PHO,21,1,242,22,76,.289,11,38,.289,11,38,.289,.362,8,12,.667,2,37,39,13,10,2,10,17,63
2018,Willie Reed,C,27,TOT,42,5,428,81,121,.669,1,2,.500,80,119,.672,.674,32,55,.582,35,86,121,10,9,22,19,56,195
2018,Josh Richardson,SF,24,MIA,81,81,2689,399,885,.451,127,336,.378,272,549,.495,.523,120,142,.845,69,216,285,231,121,75,140,199,1045
2018,Malachi Richardson,SG,22,TOT,26,4,324,30,90,.333,12,40,.300,18,50,.360,.400,17,22,.773,5,29,34,13,10,1,10,27,89
2018,Austin Rivers,SG,25,LAC,61,59,2057,341,805,.424,136,360,.378,205,445,.461,.508,102,159,.642,27,118,145,242,74,16,109,152,920
2018,Andre Roberson,SG,26,OKC,39,39,1037,87,162,.537,8,36,.222,79,126,.627,.562,12,38,.316,75,110,185,46,45,35,30,89,194
2018,Devin Robinson,SF,22,WAS,1,0,13,1,3,.333,0,0,,1,3,.333,.333,0,0,,2,3,5,0,1,0,0,2,2
2018,Glenn Robinson III,SF,24,IND,23,1,338,36,85,.424,14,34,.412,22,51,.431,.506,9,11,.818,11,26,37,17,13,1,5,14,95
2018,Rajon Rondo,PG,31,NOP,65,63,1705,231,494,.468,50,150,.333,181,344,.526,.518,25,46,.543,31,232,263,533,70,10,151,119,537
2018,Derrick Rose,PG,29,TOT,25,7,420,81,186,.435,7,30,.233,74,156,.474,.454,40,46,.870,13,22,35,37,7,4,35,16,209
2018,Terrence Ross,SG,26,ORL,24,20,600,76,191,.398,30,93,.323,46,98,.469,.476,27,36,.750,10,63,73,38,27,11,29,45,209
2018,Terry Rozier,PG,23,BOS,80,16,2068,316,800,.395,153,402,.381,163,398,.410,.491,115,149,.772,63,313,376,232,80,19,80,123,900
2018,Ricky Rubio,PG,27,UTA,77,77,2254,346,827,.418,96,273,.352,250,554,.451,.476,220,254,.866,44,307,351,410,121,11,207,206,1008
2018,D'Angelo Russell,PG,21,BRK,48,35,1234,278,672,.414,90,278,.324,188,394,.477,.481,97,131,.740,30,159,189,249,36,17,147,93,743
2018,Domantas Sabonis,C,21,IND,74,19,1810,340,661,.514,13,37,.351,327,624,.524,.524,168,224,.750,165,407,572,151,40,32,137,220,861
2018,JaKarr Sampson,SF,24,SAC,22,6,344,44,81,.543,5,10,.500,39,71,.549,.574,10,16,.625,21,57,78,9,8,22,8,48,103
2018,Dario Šarić,PF,23,PHI,78,73,2310,403,890,.453,157,399,.393,246,491,.501,.541,178,207,.860,154,366,520,202,51,20,148,160,1141
2018,Tomáš Satoranský,SG,26,WAS,73,30,1643,201,384,.523,47,101,.465,154,283,.544,.585,75,96,.781,72,161,233,286,52,15,83,131,524
2018,Dennis Schröder,PG,24,ATL,67,67,2078,500,1146,.436,76,262,.290,424,884,.480,.469,225,265,.849,44,164,208,417,72,6,183,147,1301
2018,Mike Scott,PF,29,WAS,76,1,1406,276,524,.527,66,163,.405,210,361,.582,.590,50,76,.658,50,197,247,80,23,10,79,148,668
2018,Thabo Sefolosha,SF,33,UTA,38,6,806,118,240,.492,32,84,.381,86,156,.551,.558,44,54,.815,29,132,161,33,52,12,30,59,312
2018,Wayne Selden,SG,23,MEM,35,9,692,116,269,.431,49,122,.402,67,147,.456,.522,44,59,.746,16,40,56,66,18,5,54,59,325
2018,Ramon Sessions,PG,31,TOT,28,3,392,42,117,.359,8,26,.308,34,91,.374,.393,44,57,.772,6,32,38,77,14,2,30,29,136
2018,Iman Shumpert,SG,27,CLE,14,6,276,22,58,.379,7,26,.269,15,32,.469,.440,11,15,.733,7,34,41,17,9,4,16,22,62
2018,Pascal Siakam,PF,23,TOR,81,5,1679,253,498,.508,29,132,.220,224,366,.612,.537,54,87,.621,79,285,364,159,62,42,67,166,589
2018,Xavier Silas,SG,30,BOS,2,0,7,0,3,.000,0,2,.000,0,1,.000,.000,0,0,,1,1,2,0,1,0,0,1,0
2018,Ben Simmons,PG,21,PHI,81,81,2732,544,998,.545,0,11,.000,544,987,.551,.545,191,341,.560,145,514,659,661,140,70,278,211,1279
2018,Jonathon Simmons,SG,28,ORL,69,50,2029,354,761,.465,69,204,.338,285,557,.512,.511,185,241,.768,61,178,239,171,58,16,146,175,962
2018,Kobi Simmons,PG,20,MEM,32,12,643,80,189,.423,11,39,.282,69,150,.460,.452,25,25,1.000,14,36,50,68,18,5,44,61,196
2018,Kyle Singler,SF,29,OKC,12,0,59,7,21,.333,2,5,.400,5,16,.313,.381,7,13,.538,1,9,10,2,1,0,3,4,23
2018,Marcus Smart,SG,23,BOS,54,11,1614,189,515,.367,75,249,.301,114,266,.429,.440,97,133,.729,43,146,189,259,71,23,129,133,550
2018,Dennis Smith Jr.,PG,20,DAL,69,69,2049,404,1024,.395,106,339,.313,298,685,.435,.446,134,193,.694,50,210,260,358,71,18,194,152,1048
2018,Ish Smith,PG,29,DET,82,35,2043,389,801,.486,35,101,.347,354,700,.506,.507,81,116,.698,27,197,224,360,64,20,108,140,894
2018,J.R. Smith,SG,32,CLE,80,61,2244,240,595,.403,143,381,.375,97,214,.453,.524,39,56,.696,29,206,235,141,68,11,81,161,662
2018,Jason Smith,C,31,WAS,33,2,285,45,115,.391,4,32,.125,41,83,.494,.409,19,21,.905,18,35,53,14,3,13,16,44,113
2018,Josh Smith,PF,32,NOP,3,0,12,1,4,.250,0,0,,1,4,.250,.250,0,0,,3,1,4,0,0,0,0,3,2
2018,Tony Snell,SG,26,MIL,75,59,2053,185,425,.435,108,268,.403,77,157,.490,.562,38,48,.792,9,132,141,98,47,28,36,115,516
2018,Marreese Speights,C,30,ORL,52,3,675,138,349,.395,86,233,.369,52,116,.448,.519,40,55,.727,21,112,133,40,8,22,40,106,402
2018,Nik Stauskas,SG,24,TOT,41,0,523,60,154,.390,40,100,.400,20,54,.370,.519,21,29,.724,4,60,64,39,9,4,26,24,181
2018,Lance Stephenson,SG,27,IND,82,7,1850,303,709,.427,67,232,.289,236,477,.495,.475,84,127,.661,62,362,424,235,46,17,131,177,757
2018,David Stockton,PG,26,UTA,3,0,9,2,3,.667,2,3,.667,0,0,,1.000,4,4,1.000,0,0,0,0,0,0,1,3,10
2018,Julyan Stone,SG,29,CHO,23,0,175,6,13,.462,6,13,.462,0,0,,.692,1,2,.500,1,28,29,26,4,2,7,21,19
2018,Edmond Sumner,PG,22,IND,1,0,2,1,1,1.000,0,0,,1,1,1.000,1.000,0,0,,0,1,1,0,0,0,0,1,2
2018,Caleb Swanigan,PF,20,POR,27,3,189,24,60,.400,1,8,.125,23,52,.442,.408,12,18,.667,15,39,54,14,5,3,18,37,61
2018,Jayson Tatum,SF,19,BOS,80,80,2443,397,835,.475,105,242,.434,292,593,.492,.538,213,258,.826,50,352,402,128,83,58,114,170,1112
2018,Isaiah Taylor,PG,23,ATL,67,9,1167,163,390,.418,20,80,.250,143,310,.461,.444,99,141,.702,22,72,94,206,34,10,84,116,445
2018,Jeff Teague,PG,29,MIN,70,70,2311,354,794,.446,84,228,.368,270,566,.477,.499,202,239,.845,24,185,209,492,102,23,177,171,994
2018,Marquis Teague,PG,24,MEM,3,0,74,4,16,.250,1,4,.250,3,12,.250,.281,2,5,.400,1,5,6,13,4,0,3,5,11
2018,Mirza Teletović,PF,32,MIL,10,0,159,25,57,.439,21,45,.467,4,12,.333,.623,0,0,,3,20,23,10,4,1,7,14,71
2018,Garrett Temple,SG,31,SAC,65,35,1615,199,476,.418,89,227,.392,110,249,.442,.512,60,78,.769,22,130,152,124,57,27,79,135,547
2018,Miloš Teodosić,PG,30,LAC,45,36,1134,151,360,.419,88,232,.379,63,128,.492,.542,39,46,.848,16,110,126,209,23,5,97,103,429
2018,Jason Terry,SG,40,MIL,51,4,814,59,154,.383,40,115,.348,19,39,.487,.513,8,9,.889,5,43,48,59,42,13,25,52,166
2018,Daniel Theis,C,25,BOS,63,3,936,126,233,.541,18,58,.310,108,175,.617,.579,61,81,.753,90,184,274,56,30,48,56,157,331
2018,Isaiah Thomas,PG,28,TOT,32,15,862,157,421,.373,55,188,.293,102,233,.438,.438,117,131,.893,17,50,67,153,15,3,95,58,486
2018,Lance Thomas,PF,29,NYK,73,31,1353,102,267,.382,50,124,.403,52,143,.364,.476,44,53,.830,44,131,175,44,30,14,40,134,298
2018,Klay Thompson,SG,27,GSW,73,73,2506,575,1179,.488,229,521,.440,346,658,.526,.585,82,98,.837,31,246,277,185,55,34,128,117,1461
2018,Tristan Thompson,C,26,CLE,53,22,1072,132,235,.562,0,0,,132,235,.562,.562,43,79,.544,126,226,352,33,16,17,36,102,307
2018,Sindarius Thornwell,SG,23,LAC,73,17,1156,100,233,.429,23,61,.377,77,172,.448,.479,59,88,.670,33,107,140,68,48,25,53,125,282
2018,Anthony Tolliver,PF,32,DET,79,14,1757,219,472,.464,159,365,.436,60,107,.561,.632,106,133,.797,50,191,241,90,32,21,58,144,703
2018,Karl-Anthony Towns,C,22,MIN,82,82,2918,639,1172,.545,120,285,.421,519,887,.585,.596,345,402,.858,238,774,1012,199,64,115,159,285,1743
2018,P.J. Tucker,PF,32,HOU,82,34,2281,172,441,.390,115,310,.371,57,131,.435,.520,43,60,.717,93,364,457,77,78,26,74,205,502
2018,Evan Turner,SF,29,POR,79,40,2034,258,577,.447,42,132,.318,216,445,.485,.484,91,107,.850,30,214,244,173,47,29,99,163,649
2018,Myles Turner,C,21,IND,65,62,1836,306,639,.479,56,157,.357,250,482,.519,.523,160,206,.777,93,324,417,87,38,118,96,186,828
2018,Ekpe Udoh,C,30,UTA,63,3,810,60,120,.500,0,1,.000,60,119,.504,.500,42,56,.750,68,82,150,53,43,74,20,105,162
2018,Tyler Ulis,PG,22,PHO,71,43,1658,214,551,.388,42,146,.288,172,405,.425,.426,84,101,.832,24,104,128,311,70,7,127,120,554
2018,Jonas Valančiūnas,C,25,TOR,77,77,1727,390,687,.568,30,74,.405,360,613,.587,.590,170,211,.806,183,477,660,81,29,69,115,192,980
2018,Denzel Valentine,SG,24,CHI,77,37,2095,301,721,.417,143,370,.386,158,351,.450,.517,38,51,.745,48,345,393,244,65,11,99,185,783
2018,Fred VanVleet,PG,23,TOR,76,0,1520,232,545,.426,108,261,.414,124,284,.437,.525,84,101,.832,25,159,184,243,68,19,74,130,656
2018,Rashad Vaughn,SG,21,TOT,28,0,212,23,56,.411,14,37,.378,9,19,.474,.536,4,6,.667,3,18,21,13,5,3,6,15,64
2018,Noah Vonleh,PF,22,TOT,54,16,875,104,234,.444,20,66,.303,84,168,.500,.487,36,58,.621,70,241,311,34,19,17,31,68,264
2018,Nikola Vučević,C,27,ORL,57,57,1683,399,840,.475,64,204,.314,335,636,.527,.513,77,94,.819,101,422,523,191,56,62,109,144,939
2018,Dwyane Wade,SG,36,TOT,67,3,1536,299,682,.438,32,111,.288,267,571,.468,.462,135,189,.714,50,202,252,228,61,47,140,124,765
2018,Dion Waiters,SG,26,MIA,30,30,918,163,410,.398,52,170,.306,111,240,.463,.461,51,69,.739,8,69,77,113,23,9,70,61,429
2018,Kemba Walker,PG,27,CHO,80,80,2736,588,1363,.431,231,601,.384,357,762,.469,.516,363,420,.864,32,216,248,444,91,24,179,98,1770
2018,John Wall,PG,27,WAS,41,41,1410,280,667,.420,62,167,.371,218,500,.436,.466,175,241,.726,22,128,150,393,57,45,158,80,797
2018,Tyrone Wallace,PG,23,LAC,30,19,851,110,247,.445,10,40,.250,100,207,.483,.466,61,78,.782,21,84,105,71,27,13,46,83,291
2018,Derrick Walton,PG,22,MIA,16,0,147,8,25,.320,7,17,.412,1,8,.125,.460,6,6,1.000,2,14,16,16,7,3,2,7,29
2018,Jameel Warney,PF,24,DAL,3,0,27,7,12,.583,0,0,,7,12,.583,.583,3,5,.600,4,5,9,0,0,0,1,2,17
2018,T.J. Warren,SF,24,PHO,65,65,2142,529,1063,.498,20,90,.222,509,973,.523,.507,193,255,.757,125,208,333,85,65,41,85,149,1271
2018,Travis Wear,SF,27,LAL,17,0,228,25,72,.347,17,47,.362,8,25,.320,.465,8,8,1.000,0,38,38,7,4,5,6,30,75
2018,James Webb III,SF,24,BRK,10,0,120,6,24,.250,4,19,.211,2,5,.400,.333,0,0,,8,16,24,4,1,0,4,10,16
2018,Briante Weber,PG,25,TOT,18,0,237,19,43,.442,4,11,.364,15,32,.469,.488,8,10,.800,8,27,35,22,18,5,15,28,50
2018,David West,C,37,GSW,73,0,999,216,378,.571,3,8,.375,213,370,.576,.575,60,79,.759,64,174,238,138,47,75,80,120,495
2018,Russell Westbrook,PG,29,OKC,80,80,2914,757,1687,.449,97,326,.298,660,1361,.485,.477,417,566,.737,152,652,804,820,147,20,381,200,2028
2018,Andrew White,SF,24,ATL,15,0,209,25,73,.342,18,49,.367,7,24,.292,.466,1,4,.250,4,30,34,6,3,1,8,12,69
2018,Derrick White,PG,23,SAS,17,0,139,16,33,.485,8,13,.615,8,20,.400,.606,14,20,.700,5,21,26,9,4,3,6,8,54
2018,Okaro White,PF,25,MIA,6,4,80,7,16,.438,4,11,.364,3,5,.600,.563,2,3,.667,3,8,11,2,1,1,1,6,20
2018,Isaiah Whitehead,PG,22,BRK,16,0,180,40,86,.465,7,18,.389,33,68,.485,.506,13,19,.684,4,22,26,20,8,2,24,23,100
2018,Hassan Whiteside,C,28,MIA,54,54,1364,312,578,.540,2,2,1.000,310,576,.538,.542,128,182,.703,174,444,618,54,37,94,92,131,754
2018,Andrew Wiggins,SF,22,MIN,82,82,2979,569,1300,.438,112,338,.331,457,962,.475,.481,202,314,.643,82,276,358,160,91,51,138,163,1452
2018,Jacob Wiley,PF,23,BRK,5,0,33,1,4,.250,1,2,.500,0,2,.000,.375,1,2,.500,2,9,11,2,1,0,0,4,4
2018,Damien Wilkins,SF,38,IND,19,1,152,13,39,.333,4,18,.222,9,21,.429,.385,3,4,.750,5,11,16,9,2,1,5,7,33
2018,Alan Williams,PF,25,PHO,5,0,70,7,18,.389,0,0,,7,18,.389,.389,6,9,.667,3,19,22,8,5,1,7,13,20
2018,C.J. Williams,SG,27,LAC,38,17,707,87,197,.442,22,78,.282,65,119,.546,.497,13,16,.813,12,44,56,43,31,13,20,63,209
2018,Derrick Williams,PF,26,LAL,2,0,9,1,4,.250,0,2,.000,1,2,.500,.250,0,0,,0,1,1,0,0,0,0,0,2
2018,Lou Williams,SG,31,LAC,79,19,2589,582,1337,.435,186,518,.359,396,819,.484,.505,432,491,.880,40,158,198,417,85,19,234,106,1782
2018,Marvin Williams,PF,31,CHO,78,78,2006,258,563,.458,126,305,.413,132,258,.512,.570,102,123,.829,74,296,370,96,56,38,66,116,744
2018,Matt Williams,SG,24,MIA,3,0,11,2,6,.333,1,5,.200,1,1,1.000,.417,0,0,,0,1,1,0,0,0,1,1,5
2018,Troy Williams,SF,23,TOT,21,1,307,51,109,.468,11,38,.289,40,71,.563,.518,20,30,.667,22,41,63,16,20,4,19,34,133
2018,D.J. Wilson,PF,21,MIL,22,0,71,9,16,.563,2,5,.400,7,11,.636,.625,1,2,.500,2,8,10,3,3,1,4,7,21
2018,Jamil Wilson,SF,27,LAC,15,10,274,38,81,.469,27,63,.429,11,18,.611,.636,2,4,.500,3,29,32,10,5,8,8,34,105
2018,Justise Winslow,PF,21,MIA,68,25,1680,207,488,.424,49,129,.380,158,359,.440,.474,66,104,.635,64,306,370,148,54,33,77,140,529
2018,Jeff Withey,C,27,DAL,9,0,39,6,16,.375,2,10,.200,4,6,.667,.438,1,2,.500,1,9,10,0,0,3,2,3,15
2018,Nate Wolters,PG,26,UTA,5,0,19,1,6,.167,0,0,,1,6,.167,.167,0,0,,1,1,2,1,0,0,0,1,2
2018,Brandan Wright,PF,30,TOT,28,1,381,59,102,.578,0,0,,59,102,.578,.578,21,33,.636,33,62,95,13,13,26,8,32,139
2018,Delon Wright,PG,25,TOR,69,4,1433,201,432,.465,56,153,.366,145,279,.520,.530,97,117,.829,45,153,198,200,72,33,78,81,555
2018,Guerschon Yabusele,PF,22,BOS,33,4,235,26,61,.426,12,37,.324,14,24,.583,.525,15,22,.682,17,35,52,16,4,5,12,23,79
2018,James Young,SG,22,PHI,6,0,61,5,14,.357,3,10,.300,2,4,.500,.464,4,6,.667,0,2,2,2,0,0,1,4,17
2018,Joe Young,PG,25,IND,53,1,558,80,186,.430,25,66,.379,55,120,.458,.497,22,29,.759,12,51,63,39,14,1,26,39,207
2018,Nick Young,SG,32,GSW,80,8,1393,201,488,.412,123,326,.377,78,162,.481,.538,56,65,.862,20,105,125,36,38,7,39,100,581
2018,Thaddeus Young,PF,29,IND,81,81,2607,421,864,.487,58,181,.320,363,683,.531,.521,55,92,.598,184,328,512,152,135,36,105,175,955
2018,Cody Zeller,C,25,CHO,33,0,627,85,156,.545,2,3,.667,83,153,.542,.551,61,85,.718,67,110,177,31,14,21,33,81,233
2018,Tyler Zeller,C,28,TOT,66,34,1109,187,334,.560,10,28,.357,177,306,.578,.575,57,79,.722,110,195,305,47,15,35,47,126,441
2018,Paul Zipser,SF,23,CHI,54,12,824,81,234,.346,37,110,.336,44,124,.355,.425,19,25,.760,13,118,131,46,20,15,43,86,218
2018,Ante Žižić,C,21,CLE,32,2,214,49,67,.731,0,0,,49,67,.731,.731,21,29,.724,24,36,60,5,2,13,11,30,119
2018,Ivica Zubac,C,20,LAL,43,0,410,61,122,.500,0,1,.000,61,121,.504,.500,39,51,.765,45,78,123,25,8,15,26,47,161
2019,Álex Abrines,SG,25,OKC,31,2,588,56,157,.357,41,127,.323,15,30,.500,.487,12,13,.923,5,43,48,20,17,6,14,53,165
2019,Quincy Acy,PF,28,PHO,10,0,123,4,18,.222,2,15,.133,2,3,.667,.278,7,10,.700,3,22,25,8,1,4,4,24,17
2019,Jaylen Adams,PG,22,ATL,34,1,428,38,110,.345,25,74,.338,13,36,.361,.459,7,9,.778,11,49,60,65,14,5,28,45,108
2019,Steven Adams,C,25,OKC,80,80,2669,481,809,.595,0,2,.000,481,807,.596,.595,146,292,.500,391,369,760,124,117,76,135,204,1108
2019,Bam Adebayo,C,21,MIA,82,28,1913,280,486,.576,3,15,.200,277,471,.588,.579,166,226,.735,165,432,597,184,71,65,121,203,729
2019,Deng Adel,SF,21,CLE,19,3,194,11,36,.306,6,23,.261,5,13,.385,.389,4,4,1.000,3,16,19,5,1,4,6,13,32
2019,DeVaughn Akoon-Purcell,SG,25,DEN,7,0,22,3,10,.300,0,4,.000,3,6,.500,.300,1,2,.500,1,3,4,6,2,0,2,4,7
2019,LaMarcus Aldridge,C,33,SAS,81,81,2687,684,1319,.519,10,42,.238,674,1277,.528,.522,349,412,.847,251,493,744,194,43,107,144,179,1727
2019,Rawle Alkins,SG,21,CHI,10,1,120,13,39,.333,3,12,.250,10,27,.370,.372,8,12,.667,11,15,26,13,1,0,8,7,37
2019,Grayson Allen,SG,23,UTA,38,2,416,67,178,.376,32,99,.323,35,79,.443,.466,45,60,.750,3,20,23,25,6,6,33,47,211
2019,Jarrett Allen,C,20,BRK,80,80,2096,335,568,.590,6,45,.133,329,523,.629,.595,197,278,.709,191,481,672,110,43,120,103,184,873
2019,Kadeem Allen,PG,26,NYK,19,1,416,65,141,.461,17,36,.472,48,105,.457,.521,42,54,.778,8,43,51,76,16,4,26,46,189
2019,Al-Farouq Aminu,PF,28,POR,81,81,2292,257,593,.433,96,280,.343,161,313,.514,.514,150,173,.867,112,498,610,104,68,33,72,143,760
2019,Justin Anderson,SF,25,ATL,48,4,463,64,157,.408,24,77,.312,40,80,.500,.484,26,35,.743,24,60,84,23,22,13,23,48,178
2019,Kyle Anderson,SF,25,MEM,43,40,1281,150,276,.543,9,34,.265,141,242,.583,.560,37,64,.578,48,203,251,128,54,37,58,112,346
2019,Ryan Anderson,PF,30,TOT,25,8,322,21,69,.304,9,40,.225,12,29,.414,.370,12,16,.750,18,36,54,19,4,1,14,25,63
2019,Ike Anigbogu,C,20,IND,3,0,6,0,3,.000,0,0,,0,3,.000,.000,0,0,,1,2,3,1,0,1,1,0,0
2019,Giannis Antetokounmpo,PF,24,MIL,72,72,2358,721,1247,.578,52,203,.256,669,1044,.641,.599,500,686,.729,159,739,898,424,92,110,268,232,1994
2019,Kostas Antetokounmpo,PF,21,DAL,2,0,11,0,3,.000,0,0,,0,3,.000,.000,2,4,.500,0,1,1,0,2,0,1,0,2
2019,Carmelo Anthony,PF,34,HOU,10,2,294,49,121,.405,21,64,.328,28,57,.491,.492,15,22,.682,9,45,54,5,4,7,8,32,134
2019,OG Anunoby,SF,21,TOR,67,6,1352,183,404,.453,67,202,.332,116,202,.574,.536,36,62,.581,58,139,197,47,46,22,55,140,469
2019,Ryan Arcidiacono,PG,24,CHI,81,32,1961,187,418,.447,81,217,.373,106,201,.527,.544,89,102,.873,27,192,219,269,65,4,63,171,544
2019,Trevor Ariza,SF,33,TOT,69,69,2349,294,736,.399,145,434,.334,149,302,.493,.498,130,164,.793,50,321,371,252,91,21,106,130,863
2019,D.J. Augustin,PG,31,ORL,81,81,2269,318,677,.470,131,311,.421,187,366,.511,.566,181,209,.866,41,162,203,426,52,4,128,115,948
2019,Deandre Ayton,C,20,PHO,71,70,2183,509,870,.585,0,4,.000,509,866,.588,.585,141,189,.746,223,506,729,125,61,67,126,209,1159
2019,Dwayne Bacon,SG,23,CHO,43,13,759,122,257,.475,38,87,.437,84,170,.494,.549,34,46,.739,8,81,89,47,12,5,18,72,316
2019,Marvin Bagley III,PF,19,SAC,62,4,1567,356,706,.504,30,96,.313,326,610,.534,.525,181,262,.691,162,309,471,62,33,59,98,120,923
2019,Ron Baker,SG,25,TOT,15,0,152,4,20,.200,1,13,.077,3,7,.429,.225,5,6,.833,1,10,11,15,6,1,5,18,14
2019,Wade Baldwin,PG,22,POR,16,0,94,10,33,.303,2,9,.222,8,24,.333,.333,8,11,.727,2,13,15,12,1,2,14,11,30
2019,Lonzo Ball,PG,21,LAL,47,45,1423,185,456,.406,75,228,.329,110,228,.482,.488,20,48,.417,54,197,251,255,69,19,103,114,465
2019,Mo Bamba,C,20,ORL,47,1,766,117,243,.481,21,70,.300,96,173,.555,.525,37,63,.587,64,169,233,39,13,64,43,102,292
2019,J.J. Barea,PG,34,DAL,38,0,752,161,385,.418,38,128,.297,123,257,.479,.468,55,78,.705,13,82,95,211,22,1,72,50,415
2019,Harrison Barnes,PF-SF,26,TOT,77,77,2533,431,1027,.420,174,441,.395,257,586,.439,.504,229,278,.824,57,304,361,115,50,13,98,122,1265
2019,Will Barton,SF,28,DEN,43,38,1189,185,460,.402,67,196,.342,118,264,.447,.475,57,74,.770,32,167,199,124,18,22,65,82,494
2019,Keita Bates-Diop,SF,23,MIN,30,3,503,60,142,.423,13,52,.250,47,90,.522,.468,18,28,.643,16,67,83,17,18,14,14,29,151
2019,Nicolas Batum,SF,30,CHO,75,72,2354,253,562,.450,116,298,.389,137,264,.519,.553,77,89,.865,71,319,390,247,71,43,117,140,699
2019,Jerryd Bayless,PG,30,MIN,34,6,657,82,230,.357,29,98,.296,53,132,.402,.420,16,28,.571,11,51,62,119,18,2,32,56,209
2019,Aron Baynes,C,32,BOS,51,18,821,105,223,.471,21,61,.344,84,162,.519,.518,53,62,.855,88,152,240,57,12,34,40,125,284
2019,Kent Bazemore,SG,29,ATL,67,35,1643,278,691,.402,96,300,.320,182,391,.465,.472,127,175,.726,37,224,261,152,89,42,121,170,779
2019,Bradley Beal,SG,25,WAS,82,82,3028,764,1609,.475,209,596,.351,555,1013,.548,.540,362,448,.808,89,322,411,448,121,58,224,226,2099
2019,Malik Beasley,SG,22,DEN,81,18,1879,349,737,.474,163,405,.402,186,332,.560,.584,56,66,.848,35,165,200,97,55,10,55,116,917
2019,Michael Beasley,PF,30,LAL,26,2,277,75,153,.490,3,17,.176,72,136,.529,.500,28,39,.718,13,47,60,25,9,10,27,42,181
2019,Marco Belinelli,SG,32,SAS,79,1,1815,285,690,.413,147,395,.372,138,295,.468,.520,112,124,.903,16,182,198,132,35,8,72,121,829
2019,Jordan Bell,C,24,GSW,68,3,788,99,192,.516,0,2,.000,99,190,.521,.516,25,41,.610,55,129,184,76,20,51,42,80,223
2019,DeAndre' Bembry,SG,24,ATL,82,15,1931,275,616,.446,50,173,.289,225,443,.508,.487,87,136,.640,54,304,358,202,105,41,142,190,687
2019,Dragan Bender,PF,21,PHO,46,27,826,88,197,.447,22,101,.218,66,96,.688,.503,32,54,.593,34,149,183,56,18,22,37,90,230
2019,Dairis Bertāns,SG,29,NOP,12,0,167,12,47,.255,10,34,.294,2,13,.154,.362,0,0,,2,7,9,10,1,0,2,7,34
2019,Dāvis Bertāns,PF,26,SAS,76,12,1632,204,453,.450,145,338,.429,59,115,.513,.610,53,60,.883,23,241,264,100,35,33,43,133,606
2019,Patrick Beverley,PG,30,LAC,78,49,2137,194,477,.407,112,282,.397,82,195,.421,.524,96,123,.780,76,312,388,300,67,43,85,265,596
2019,Khem Birch,C,26,ORL,50,1,643,91,151,.603,0,1,.000,91,150,.607,.603,58,83,.699,79,111,190,38,18,29,20,72,240
2019,Bismack Biyombo,C,26,CHO,54,32,783,89,156,.571,0,0,,89,156,.571,.571,58,91,.637,81,166,247,33,11,41,34,103,236
2019,Nemanja Bjelica,PF,30,SAC,77,70,1788,284,593,.479,103,257,.401,181,336,.539,.566,70,92,.761,125,319,444,147,54,56,82,197,741
2019,Antonio Blakeney,SG,22,CHI,57,3,829,166,396,.419,36,91,.396,130,305,.426,.465,50,76,.658,7,99,106,42,12,9,35,41,418
2019,Eric Bledsoe,PG,29,MIL,78,78,2272,470,971,.484,124,377,.329,346,594,.582,.548,177,236,.750,82,280,362,430,116,29,165,156,1241
2019,Jaron Blossomgame,SF,25,CLE,27,4,439,47,106,.443,10,39,.256,37,67,.552,.491,10,13,.769,26,72,98,13,7,8,11,20,114
2019,Bogdan Bogdanović,SG,26,SAC,70,17,1947,361,863,.418,134,372,.360,227,491,.462,.496,134,162,.827,40,203,243,267,72,15,117,142,990
2019,Bojan Bogdanović,SF,29,IND,81,81,2573,522,1051,.497,164,386,.425,358,665,.538,.575,246,305,.807,33,300,333,161,69,1,134,138,1454
2019,Andrew Bogut,C,34,GSW,11,5,134,18,36,.500,0,0,,18,36,.500,.500,3,3,1.000,12,43,55,11,3,8,8,22,39
2019,Jonah Bolden,PF,23,PHI,44,10,639,80,162,.494,34,96,.354,46,66,.697,.599,13,27,.481,47,118,165,40,17,39,36,99,207
2019,Isaac Bonga,PG,19,LAL,22,0,120,5,33,.152,0,8,.000,5,25,.200,.152,9,15,.600,9,16,25,15,9,4,6,9,19
2019,Devin Booker,SG,22,PHO,64,64,2242,586,1255,.467,135,414,.326,451,841,.536,.521,393,454,.866,39,226,265,433,56,13,264,200,1700
2019,Chris Boucher,PF,26,TOR,28,0,163,34,76,.447,12,37,.324,22,39,.564,.526,13,15,.867,16,40,56,2,6,24,7,31,93
2019,Avery Bradley,SG,28,TOT,63,63,1905,248,608,.408,86,245,.351,162,363,.446,.479,43,50,.860,43,132,175,152,41,16,89,167,625
2019,Tony Bradley,C,21,UTA,3,0,36,8,16,.500,0,0,,8,16,.500,.500,1,2,.500,9,6,15,1,2,2,3,6,17
2019,Corey Brewer,SF,32,TOT,31,3,492,53,123,.431,14,44,.318,39,79,.494,.488,31,43,.721,26,50,76,39,32,7,19,63,151
2019,Mikal Bridges,SF,22,PHO,82,56,2417,242,563,.430,105,313,.335,137,250,.548,.523,95,118,.805,56,208,264,173,129,38,70,201,684
2019,Miles Bridges,SF,20,CHO,80,25,1696,237,511,.464,65,200,.325,172,311,.553,.527,58,77,.753,67,256,323,95,55,49,50,111,597
2019,Isaiah Briscoe,PG,22,ORL,39,0,559,55,138,.399,11,34,.324,44,104,.423,.438,15,26,.577,5,69,74,87,11,2,31,66,136
2019,Ryan Broekhoff,SG,28,DAL,42,0,453,57,126,.452,38,93,.409,19,33,.576,.603,15,19,.789,8,55,63,22,6,4,16,35,167
2019,Malcolm Brogdon,SG,26,MIL,64,64,1832,378,748,.505,104,244,.426,274,504,.544,.575,141,152,.928,65,223,288,205,46,13,91,102,1001
2019,Dillon Brooks,SF,23,MEM,18,0,330,49,122,.402,15,40,.375,34,82,.415,.463,22,30,.733,9,22,31,16,10,4,19,50,135
2019,MarShon Brooks,SG,30,MEM,29,0,387,76,169,.450,15,54,.278,61,115,.530,.494,23,33,.697,12,33,45,25,9,4,21,33,190
2019,Bruce Brown,SG,22,DET,74,56,1449,125,314,.398,24,93,.258,101,221,.457,.436,45,60,.750,48,137,185,91,40,36,46,178,319
2019,Jaylen Brown,SG,22,BOS,74,25,1913,368,792,.465,95,276,.344,273,516,.529,.525,133,202,.658,65,248,313,100,69,32,99,186,964
2019,Lorenzo Brown,PG,28,TOR,26,0,212,23,71,.324,6,28,.214,17,43,.395,.366,3,3,1.000,5,26,31,28,12,5,16,22,55
2019,Sterling Brown,SG,23,MIL,58,7,1034,145,312,.465,53,147,.361,92,165,.558,.550,29,42,.690,29,155,184,84,25,8,46,88,372
2019,Troy Brown Jr.,SF,19,WAS,52,10,730,97,234,.415,22,69,.319,75,165,.455,.462,32,47,.681,35,110,145,80,21,5,30,56,248
2019,Jalen Brunson,PG,22,DAL,73,38,1591,264,565,.467,63,181,.348,201,384,.523,.523,87,120,.725,25,144,169,230,37,4,88,127,678
2019,Thomas Bryant,C,21,WAS,72,53,1496,309,502,.616,33,99,.333,276,403,.685,.648,107,137,.781,113,341,454,92,25,67,60,126,758
2019,Reggie Bullock,SG,27,TOT,63,60,1879,245,594,.412,148,393,.377,97,201,.483,.537,73,85,.859,22,151,173,129,40,12,65,109,711
2019,Trey Burke,PG,26,TOT,58,8,1125,236,548,.431,56,159,.352,180,389,.463,.482,103,124,.831,28,71,99,159,33,7,49,58,631
2019,Alec Burks,SG,27,TOT,64,24,1375,192,474,.405,61,168,.363,131,306,.428,.469,116,141,.823,30,205,235,128,39,21,65,91,561
2019,Deonte Burton,SG,25,OKC,32,0,240,33,82,.402,8,27,.296,25,55,.455,.451,8,12,.667,4,24,28,9,6,8,9,31,82
2019,Jimmy Butler,SF-SG,29,TOT,65,65,2185,418,904,.462,67,193,.347,351,711,.494,.499,312,365,.855,121,221,342,263,123,39,95,111,1215
2019,Bruno Caboclo,PF,23,MEM,34,19,800,96,225,.427,48,130,.369,48,95,.505,.533,42,50,.840,42,116,158,50,14,33,38,81,282
2019,José Calderón,PG,37,DET,49,0,632,45,120,.375,14,57,.246,31,63,.492,.433,9,11,.818,11,49,60,115,16,3,35,64,113
2019,Kentavious Caldwell-Pope,SG,25,LAL,82,23,2035,325,756,.430,151,435,.347,174,321,.542,.530,137,158,.867,48,190,238,110,73,13,65,137,938
2019,Isaiah Canaan,PG,27,TOT,30,16,629,64,164,.390,34,96,.354,30,68,.441,.494,19,24,.792,6,52,58,84,14,2,35,52,181
2019,Clint Capela,C,24,HOU,67,67,2249,474,732,.648,0,0,,474,732,.648,.648,166,261,.636,298,550,848,96,44,102,94,168,1114
2019,DeMarre Carroll,PF,32,BRK,67,8,1703,227,575,.395,106,310,.342,121,265,.457,.487,184,242,.760,68,281,349,85,31,10,73,114,744
2019,Jevon Carter,PG,23,MEM,39,3,577,56,185,.303,34,102,.333,22,83,.265,.395,26,32,.813,14,52,66,69,26,11,33,55,172
2019,Vince Carter,PF,42,ATL,76,9,1330,196,468,.419,123,316,.389,73,152,.480,.550,47,66,.712,31,163,194,87,44,27,48,141,562
2019,Wendell Carter Jr.,C,19,CHI,44,44,1110,180,371,.485,6,32,.188,174,339,.513,.493,89,112,.795,87,220,307,78,26,58,65,152,455
2019,Michael Carter-Williams,PG,27,TOT,28,1,372,46,123,.374,10,38,.263,36,85,.424,.415,32,53,.604,19,51,70,70,20,15,20,48,134
2019,Alex Caruso,PG,24,LAL,25,4,531,77,173,.445,24,50,.480,53,123,.431,.514,51,64,.797,20,47,67,77,24,9,42,54,229
2019,Omri Casspi,SF,30,MEM,36,0,520,86,161,.534,15,43,.349,71,118,.602,.581,39,58,.672,17,98,115,26,20,9,23,35,226
2019,Willie Cauley-Stein,C,25,SAC,81,81,2213,412,741,.556,1,2,.500,411,739,.556,.557,140,254,.551,181,497,678,194,96,51,84,227,965
2019,Troy Caupain,PG,23,ORL,4,0,16,4,8,.500,2,3,.667,2,5,.400,.625,0,0,,1,2,3,4,1,0,0,0,10
2019,Tyler Cavanaugh,PF,24,UTA,11,0,39,3,10,.300,1,5,.200,2,5,.400,.350,2,2,1.000,3,5,8,1,0,0,1,3,9
2019,Tyson Chandler,C,36,TOT,55,6,875,61,99,.616,0,1,.000,61,98,.622,.616,51,87,.586,92,215,307,37,21,23,42,110,173
2019,Wilson Chandler,PF-SF,31,TOT,51,33,1177,114,273,.418,59,158,.373,55,115,.478,.526,18,25,.720,48,167,215,82,25,21,46,123,305
2019,Joe Chealey,PG,23,CHO,1,0,8,1,3,.333,0,0,,1,3,.333,.333,0,0,,0,0,0,1,0,0,0,1,2
2019,Chris Chiozza,PG,23,HOU,7,0,33,2,8,.250,2,5,.400,0,3,.000,.375,0,0,,1,3,4,4,1,1,1,2,6
2019,Marquese Chriss,PF,21,TOT,43,2,499,67,180,.372,16,72,.222,51,108,.472,.417,32,45,.711,40,102,142,22,17,11,36,81,182
2019,Gary Clark,PF,24,HOU,51,2,641,50,151,.331,41,138,.297,9,13,.692,.467,7,7,1.000,24,92,116,18,20,26,7,47,148
2019,Ian Clark,SG,27,NOP,60,6,973,151,383,.394,66,202,.327,85,181,.470,.480,33,37,.892,13,76,89,94,22,8,58,95,401
2019,Jordan Clarkson,SG,26,CLE,81,0,2214,529,1180,.448,144,445,.324,385,735,.524,.509,162,192,.844,82,188,270,196,57,13,135,112,1364
2019,John Collins,PF,21,ATL,61,59,1829,465,831,.560,55,158,.348,410,673,.609,.593,203,266,.763,219,376,595,121,22,39,120,199,1188
2019,Zach Collins,C,21,POR,77,0,1356,189,400,.473,40,121,.331,149,279,.534,.523,94,126,.746,109,215,324,71,25,66,77,174,512
2019,Darren Collison,PG,31,IND,76,76,2143,308,659,.467,79,194,.407,229,465,.492,.527,158,190,.832,36,196,232,459,110,9,125,138,853
2019,Bonzie Colson,SF,23,MIL,8,2,98,13,39,.333,5,21,.238,8,18,.444,.397,8,9,.889,8,22,30,3,5,1,3,3,39
2019,Mike Conley,PG,31,MEM,70,70,2342,490,1120,.438,155,426,.364,335,694,.483,.507,343,406,.845,40,199,239,449,94,22,130,123,1478
2019,Pat Connaughton,SG,26,MIL,61,2,1261,163,350,.466,66,200,.330,97,150,.647,.560,29,40,.725,61,197,258,122,33,25,33,81,421
2019,Quinn Cook,PG,25,GSW,74,10,1059,204,439,.465,81,200,.405,123,239,.515,.557,20,26,.769,22,135,157,116,20,3,50,92,509
2019,DeMarcus Cousins,C,28,GSW,30,30,771,178,371,.480,26,95,.274,152,276,.551,.515,106,144,.736,43,204,247,107,40,44,72,109,488
2019,Robert Covington,SF,28,TOT,35,35,1203,156,362,.431,85,225,.378,71,137,.518,.548,68,89,.764,28,165,193,46,74,47,47,126,465
2019,Allen Crabbe,SG,26,BRK,43,20,1133,137,373,.367,98,259,.378,39,114,.342,.499,41,56,.732,16,132,148,46,23,13,46,102,413
2019,Torrey Craig,SF,28,DEN,75,37,1503,160,362,.442,61,188,.324,99,174,.569,.526,49,70,.700,89,174,263,72,37,46,44,175,430
2019,Jamal Crawford,SG,38,PHO,64,0,1211,174,438,.397,67,202,.332,107,236,.453,.474,93,110,.845,8,77,85,229,33,12,99,75,508
2019,Mitch Creek,SF,26,TOT,5,0,48,8,16,.500,0,2,.000,8,14,.571,.500,5,7,.714,6,6,12,6,2,0,1,3,21
2019,Jae Crowder,SF,28,UTA,80,11,2166,318,797,.399,173,522,.331,145,275,.527,.508,142,197,.721,60,324,384,133,64,31,85,170,951
2019,Dante Cunningham,PF,31,SAS,64,21,928,75,158,.475,30,65,.462,45,93,.484,.570,14,18,.778,48,140,188,50,27,13,22,71,194
2019,Seth Curry,SG,28,POR,74,2,1399,212,465,.456,113,251,.450,99,214,.463,.577,44,52,.846,27,93,120,66,36,12,61,97,581
2019,Stephen Curry,PG,30,GSW,69,69,2331,632,1340,.472,354,810,.437,278,530,.525,.604,263,287,.916,45,324,369,361,92,25,192,166,1881
2019,Troy Daniels,SG,27,PHO,51,1,760,113,275,.411,74,194,.381,39,81,.481,.545,18,23,.783,13,60,73,26,26,5,27,79,318
2019,Anthony Davis,C,25,NOP,56,56,1850,530,1026,.517,48,145,.331,482,881,.547,.540,344,433,.794,174,498,672,218,88,135,112,132,1452
2019,Deyonta Davis,C,22,ATL,9,0,118,15,22,.682,0,1,.000,15,21,.714,.682,6,10,.600,10,26,36,5,3,5,3,12,36
2019,Ed Davis,C,29,BRK,81,1,1446,186,302,.616,0,2,.000,186,300,.620,.616,100,162,.617,216,478,694,61,35,33,64,226,472
2019,Tyler Davis,C,21,OKC,1,0,1,0,1,.000,0,0,,0,1,.000,.000,0,0,,1,0,1,0,0,0,0,0,0
2019,Dewayne Dedmon,C,29,ATL,64,52,1609,259,526,.492,83,217,.382,176,309,.570,.571,92,113,.814,105,375,480,90,69,71,84,214,693
2019,Sam Dekker,PF,24,TOT,47,5,788,120,256,.469,19,62,.306,101,194,.521,.506,28,46,.609,53,95,148,46,38,7,24,47,287
2019,Ángel Delgado,C,24,LAC,2,0,15,1,5,.200,0,0,,1,5,.200,.200,1,2,.500,2,2,4,0,1,0,0,2,3
2019,Matthew Dellavedova,PG,28,TOT,48,0,812,98,242,.405,44,130,.338,54,112,.482,.496,42,52,.808,6,71,77,181,14,2,68,75,282
2019,Luol Deng,SF,33,MIN,22,2,392,59,118,.500,14,44,.318,45,74,.608,.559,25,35,.714,20,53,73,18,15,8,14,24,157
2019,DeMar DeRozan,SG,29,SAS,77,77,2688,631,1313,.481,7,45,.156,624,1268,.492,.483,366,441,.830,54,408,462,475,86,36,199,177,1635
2019,Marcus Derrickson,PF,22,GSW,11,0,67,16,33,.485,10,20,.500,6,13,.462,.636,4,5,.800,8,5,13,1,0,1,3,9,46
2019,Cheick Diallo,PF,22,NOP,64,1,896,168,271,.620,1,4,.250,167,267,.625,.622,50,67,.746,75,257,332,33,29,33,49,113,387
2019,Hamidou Diallo,SG,20,OKC,51,3,526,75,165,.455,4,24,.167,71,141,.504,.467,36,59,.610,38,59,97,17,21,10,23,77,190
2019,Gorgui Dieng,C,29,MIN,76,2,1031,189,377,.501,19,56,.339,170,321,.530,.527,88,106,.830,81,230,311,72,48,41,57,134,485
2019,Spencer Dinwiddie,PG,25,BRK,68,4,1914,366,828,.442,124,370,.335,242,458,.528,.517,287,356,.806,26,140,166,311,40,17,152,187,1143
2019,Donte DiVincenzo,SG,22,MIL,27,0,411,50,124,.403,22,83,.265,28,41,.683,.492,9,12,.750,16,49,65,31,13,6,19,38,131
2019,Luka Dončić,SG,19,DAL,72,72,2318,506,1186,.427,168,514,.327,338,672,.503,.497,346,485,.713,86,477,563,429,77,25,247,137,1526
2019,Tyler Dorsey,SG,22,TOT,48,11,698,107,264,.405,44,132,.333,63,132,.477,.489,38,61,.623,27,86,113,56,14,2,27,53,296
2019,Damyean Dotson,SG,24,NYK,73,40,2004,290,698,.415,126,342,.368,164,356,.461,.506,73,98,.745,34,228,262,135,58,10,71,135,779
2019,PJ Dozier,SG,22,BOS,6,0,51,8,21,.381,2,8,.250,6,13,.462,.429,1,2,.500,6,11,17,5,2,0,0,2,19
2019,Goran Dragić,PG,32,MIA,36,22,991,179,433,.413,57,164,.348,122,269,.454,.479,79,101,.782,20,91,111,174,30,5,71,81,494
2019,Andre Drummond,C,25,DET,79,79,2647,561,1052,.533,5,38,.132,556,1014,.548,.536,243,412,.590,423,809,1232,112,136,138,175,272,1370
2019,Jared Dudley,PF,33,BRK,59,25,1220,101,239,.423,53,151,.351,48,88,.545,.533,32,46,.696,34,121,155,83,36,16,43,131,287
2019,Kris Dunn,PG,24,CHI,46,44,1389,215,506,.425,34,96,.354,181,410,.441,.458,55,69,.797,19,168,187,277,68,21,104,166,519
2019,Kevin Durant,SF,30,GSW,78,78,2702,721,1383,.521,137,388,.353,584,995,.587,.571,448,506,.885,33,464,497,457,58,84,225,155,2027
2019,Trevon Duval,PG,20,MIL,3,0,6,2,3,.667,1,1,1.000,1,2,.500,.833,0,0,,0,1,1,2,0,0,0,0,5
2019,Vince Edwards,SF,22,HOU,2,0,16,1,4,.250,1,4,.250,0,0,,.375,0,0,,1,1,2,0,0,0,0,0,3
2019,Henry Ellenson,PF,22,TOT,19,0,259,39,95,.411,17,38,.447,22,57,.386,.500,19,25,.760,5,61,66,16,7,2,9,27,114
2019,Wayne Ellington,SG,31,TOT,53,38,1297,184,457,.403,138,372,.371,46,85,.541,.554,39,49,.796,14,93,107,72,54,6,40,92,545
2019,Joel Embiid,C,24,PHI,64,64,2154,580,1199,.484,79,263,.300,501,936,.535,.517,522,649,.804,160,711,871,234,46,122,226,211,1761
2019,James Ennis III,SF,28,TOT,58,27,1230,138,294,.469,55,156,.353,83,138,.601,.563,58,81,.716,60,122,182,41,41,23,34,150,389
2019,Drew Eubanks,PF,21,SAS,23,0,113,15,26,.577,0,0,,15,26,.577,.577,11,13,.846,6,28,34,7,2,5,8,11,41
2019,Jacob Evans,SG,21,GSW,30,1,204,18,53,.340,4,15,.267,14,38,.368,.377,0,1,.000,6,19,25,23,5,3,11,28,40
2019,Jawun Evans,PG,22,TOT,8,0,65,3,14,.214,0,3,.000,3,11,.273,.214,0,0,,1,11,12,10,3,0,6,8,6
2019,Tyreke Evans,SG,29,IND,69,18,1402,257,660,.389,77,216,.356,180,444,.405,.448,115,160,.719,33,168,201,166,58,18,118,117,706
2019,Dante Exum,PG,23,UTA,42,1,664,101,241,.419,18,62,.290,83,179,.464,.456,68,86,.791,16,52,68,110,14,5,52,69,288
2019,Kenneth Faried,C,29,TOT,37,13,728,156,265,.589,8,25,.320,148,240,.617,.604,64,99,.646,97,153,250,20,17,23,33,82,384
2019,Derrick Favors,C,27,UTA,76,70,1766,363,619,.586,17,78,.218,346,541,.640,.600,154,228,.675,207,353,560,89,56,106,84,163,897
2019,Cristiano Felício,C,26,CHI,60,0,746,95,179,.531,0,4,.000,95,175,.543,.531,50,73,.685,79,139,218,37,11,7,33,69,240
2019,Raymond Felton,PG,34,OKC,33,0,379,55,135,.407,20,61,.328,35,74,.473,.481,12,13,.923,4,30,34,52,10,6,14,29,142
2019,Terrance Ferguson,SG,20,OKC,74,74,1931,185,431,.429,106,290,.366,79,141,.560,.552,37,51,.725,33,108,141,72,40,16,47,231,513
2019,Yogi Ferrell,PG,25,SAC,71,3,1067,153,352,.435,54,149,.362,99,203,.488,.511,60,67,.896,13,96,109,137,36,4,40,64,420
2019,Dorian Finney-Smith,SF,25,DAL,81,26,1985,228,528,.432,79,254,.311,149,274,.544,.507,73,103,.709,138,251,389,95,69,36,74,186,608
2019,Bryn Forbes,SG,25,SAS,82,81,2293,361,791,.456,176,413,.426,185,378,.489,.568,69,78,.885,18,221,239,175,45,4,80,159,967
2019,Evan Fournier,SG,26,ORL,81,81,2553,468,1069,.438,153,450,.340,315,619,.509,.509,137,170,.806,38,220,258,295,71,12,154,225,1226
2019,De'Aaron Fox,PG,21,SAC,81,81,2546,505,1102,.458,86,232,.371,419,870,.482,.497,303,417,.727,43,261,304,590,133,45,227,204,1399
2019,Melvin Frazier,SG,22,ORL,10,0,44,7,21,.333,0,6,.000,7,15,.467,.333,1,4,.250,3,2,5,1,1,0,1,6,15
2019,Tim Frazier,PG,28,TOT,59,19,1120,116,261,.444,37,101,.366,79,160,.494,.515,41,54,.759,41,127,168,248,30,5,76,112,310
2019,Jimmer Fredette,SG,29,PHO,6,0,65,8,29,.276,0,13,.000,8,16,.500,.276,6,6,1.000,1,6,7,8,3,0,5,5,22
2019,Enes Freedom,C,26,TOT,67,31,1640,375,683,.549,10,34,.294,365,649,.562,.556,155,197,.787,257,402,659,116,32,26,118,167,915
2019,Channing Frye,C,35,CLE,36,6,341,43,117,.368,32,79,.405,11,38,.289,.504,11,14,.786,4,48,52,20,6,5,13,44,129
2019,Markelle Fultz,SG,20,PHI,19,15,427,65,155,.419,4,14,.286,61,141,.433,.432,21,37,.568,26,44,70,59,17,5,25,52,155
2019,Danilo Gallinari,SF,30,LAC,68,68,2059,409,884,.463,161,372,.433,248,512,.484,.554,367,406,.904,54,363,417,178,49,23,99,129,1346
2019,Langston Galloway,SG,27,DET,80,4,1745,228,587,.388,135,380,.355,93,207,.449,.503,81,96,.844,49,122,171,85,37,8,24,135,672
2019,Billy Garrett,SG,24,NYK,4,0,63,11,27,.407,0,8,.000,11,19,.579,.407,4,4,1.000,0,3,3,7,1,1,2,3,26
2019,Marc Gasol,C,34,TOT,79,72,2436,390,870,.448,99,273,.363,291,597,.487,.505,192,253,.759,80,547,627,349,84,86,155,217,1071
2019,Pau Gasol,C,38,TOT,30,6,360,42,94,.447,6,13,.462,36,81,.444,.479,28,40,.700,22,115,137,52,5,15,16,29,118
2019,Rudy Gay,PF,32,SAS,69,51,1842,376,746,.504,74,184,.402,302,562,.537,.554,120,147,.816,63,407,470,182,54,34,114,159,946
2019,Paul George,SF,28,OKC,77,77,2841,707,1614,.438,292,757,.386,415,857,.484,.529,453,540,.839,105,523,628,318,170,34,205,214,2159
2019,Taj Gibson,PF,33,MIN,70,57,1686,304,537,.566,11,34,.324,293,503,.583,.576,134,177,.757,172,286,458,84,53,39,73,186,753
2019,Harry Giles,PF,20,SAC,58,0,820,175,348,.503,0,6,.000,175,342,.512,.503,58,91,.637,66,156,222,85,31,22,73,150,408
2019,Shai Gilgeous-Alexander,PG,20,LAC,82,73,2174,341,716,.476,51,139,.367,290,577,.503,.512,156,195,.800,57,175,232,270,96,45,141,175,889
2019,Rudy Gobert,C,26,UTA,81,80,2577,476,712,.669,0,0,,476,712,.669,.669,332,522,.636,309,732,1041,161,66,187,130,231,1284
2019,Brandon Goodwin,PG,23,DEN,16,0,57,6,23,.261,2,6,.333,4,17,.235,.304,9,11,.818,1,2,3,14,0,0,3,7,23
2019,Aaron Gordon,PF,23,ORL,78,78,2633,470,1046,.449,121,347,.349,349,699,.499,.507,185,253,.731,129,445,574,289,57,56,162,172,1246
2019,Eric Gordon,SG,30,HOU,68,53,2158,384,938,.409,216,600,.360,168,338,.497,.525,119,152,.783,17,131,148,129,41,27,90,143,1103
2019,Marcin Gortat,C,34,LAC,47,43,751,99,186,.532,0,0,,99,186,.532,.532,35,48,.729,67,194,261,65,6,24,50,92,233
2019,Devonte' Graham,PG,23,CHO,46,3,676,74,216,.343,34,121,.281,40,95,.421,.421,35,46,.761,10,53,63,121,23,2,30,48,217
2019,Treveon Graham,SG,25,BRK,35,21,715,64,191,.335,38,128,.297,26,63,.413,.435,18,22,.818,23,84,107,34,13,7,17,68,184
2019,Jerami Grant,PF,24,OKC,80,77,2612,409,823,.497,115,293,.392,294,530,.555,.567,157,221,.710,96,321,417,79,61,100,67,214,1090
2019,Jerian Grant,PG,26,ORL,60,1,939,92,220,.418,40,110,.364,52,110,.473,.509,26,40,.650,19,79,98,156,44,6,51,78,250
2019,Donte Grantham,SF,23,OKC,3,0,2,0,2,.000,0,2,.000,0,0,,.000,0,0,,0,0,0,0,0,0,0,0,0
2019,Danny Green,SG,31,TOR,80,80,2216,293,630,.465,198,435,.455,95,195,.487,.622,37,44,.841,60,257,317,126,73,53,75,171,821
2019,Draymond Green,PF,28,GSW,66,66,2065,188,422,.445,47,165,.285,141,257,.549,.501,63,91,.692,60,421,481,454,95,70,169,197,486
2019,Gerald Green,SG,33,HOU,73,0,1473,231,578,.400,156,441,.354,75,137,.547,.535,57,68,.838,30,152,182,40,33,27,55,126,675
2019,JaMychal Green,PF,28,TOT,65,6,1371,230,476,.483,71,176,.403,159,300,.530,.558,80,101,.792,104,305,409,50,45,34,87,193,611
2019,Jeff Green,PF,32,WAS,77,44,2097,326,687,.475,111,320,.347,215,367,.586,.555,183,206,.888,57,252,309,137,43,39,101,160,946
2019,Blake Griffin,PF,29,DET,75,75,2622,619,1341,.462,189,522,.362,430,819,.525,.532,414,550,.753,100,465,565,402,52,28,253,199,1841
2019,Daniel Hamilton,SG,23,ATL,19,3,204,23,60,.383,8,23,.348,15,37,.405,.450,3,6,.500,10,37,47,22,6,1,16,19,57
2019,Dusty Hannahs,SG,25,MEM,2,0,26,3,12,.250,0,5,.000,3,7,.429,.250,2,2,1.000,0,1,1,5,1,0,1,1,8
2019,Tim Hardaway Jr.,SG,26,TOT,65,63,2057,390,993,.393,162,477,.340,228,516,.442,.474,232,276,.841,33,189,222,159,54,8,105,141,1174
2019,James Harden,PG,29,HOU,78,78,2867,843,1909,.442,378,1028,.368,465,881,.528,.541,754,858,.879,66,452,518,586,158,58,387,244,2818
2019,Maurice Harkless,SF,25,POR,60,53,1415,189,388,.487,33,120,.275,156,268,.582,.530,49,73,.671,77,192,269,74,67,53,45,163,460
2019,Montrezl Harrell,C,25,LAC,82,5,2158,546,888,.615,3,17,.176,543,871,.623,.617,266,414,.643,184,351,535,162,71,110,132,255,1361
2019,Devin Harris,PG,35,DAL,68,2,1071,132,347,.380,62,200,.310,70,147,.476,.470,102,134,.761,12,100,112,122,35,16,56,133,428
2019,Gary Harris,SG,24,DEN,57,48,1639,270,637,.424,82,242,.339,188,395,.476,.488,115,144,.799,41,119,160,127,55,19,68,113,737
2019,Joe Harris,SG,27,BRK,76,76,2293,374,748,.500,183,386,.474,191,362,.528,.622,110,133,.827,52,239,291,181,38,17,121,182,1041
2019,Tobias Harris,PF,26,TOT,82,82,2847,611,1254,.487,156,393,.397,455,861,.528,.549,266,307,.866,69,576,645,229,51,37,151,184,1644
2019,Andrew Harrison,PG,24,TOT,17,0,187,16,53,.302,5,25,.200,11,28,.393,.349,17,18,.944,6,14,20,24,4,2,12,34,54
2019,Shaquille Harrison,SG,25,CHI,73,11,1430,184,426,.432,24,89,.270,160,337,.475,.460,82,123,.667,33,189,222,139,89,30,60,124,474
2019,Josh Hart,SG,23,LAL,67,22,1715,189,464,.407,92,274,.336,97,190,.511,.506,55,80,.688,35,213,248,93,64,40,58,147,525
2019,Isaiah Hartenstein,PF,20,HOU,28,0,221,20,41,.488,2,6,.333,18,35,.514,.512,11,14,.786,21,26,47,15,7,12,13,56,53
2019,Udonis Haslem,C,38,MIA,10,1,74,11,33,.333,0,12,.000,11,21,.524,.333,3,4,.750,3,24,27,2,0,0,3,9,25
2019,Gordon Hayward,PF,28,BOS,72,18,1863,296,635,.466,77,231,.333,219,404,.542,.527,156,187,.834,51,271,322,244,62,23,105,104,825
2019,John Henson,C,28,MIL,14,0,188,31,67,.463,11,31,.355,20,36,.556,.545,6,10,.600,16,55,71,14,7,11,12,16,79
2019,Juancho Hernangómez,PF,23,DEN,70,25,1358,138,314,.439,66,181,.365,72,133,.541,.545,66,86,.767,64,201,265,55,27,24,37,94,408
2019,Willy Hernangómez,C,24,CHO,58,3,812,153,295,.519,15,39,.385,138,256,.539,.544,100,144,.694,117,194,311,60,16,20,58,98,421
2019,Mario Hezonja,SF,23,NYK,58,24,1206,191,464,.412,42,152,.276,149,312,.478,.457,87,114,.763,28,211,239,88,57,8,88,110,511
2019,Isaiah Hicks,PF,24,NYK,3,0,32,4,8,.500,0,0,,4,8,.500,.500,4,5,.800,2,5,7,2,1,3,1,5,12
2019,Buddy Hield,SG,26,SAC,82,82,2615,623,1360,.458,278,651,.427,345,709,.487,.560,171,193,.886,106,306,412,205,58,33,146,202,1695
2019,Haywood Highsmith,SF,22,PHI,5,0,40,4,10,.400,1,5,.200,3,5,.600,.450,0,2,.000,0,5,5,2,1,0,1,1,9
2019,Nenê,C,36,HOU,42,2,546,60,116,.517,0,3,.000,60,113,.531,.517,31,47,.660,34,89,123,26,18,15,11,87,151
2019,George Hill,PG,32,TOT,60,13,1302,170,376,.452,48,153,.314,122,223,.547,.516,70,85,.824,39,109,148,135,52,8,51,102,458
2019,Solomon Hill,SF,27,NOP,44,15,878,68,178,.382,32,101,.317,36,77,.468,.472,23,32,.719,34,99,133,55,23,10,31,80,191
2019,Aaron Holiday,PG,22,IND,50,0,646,105,262,.401,43,127,.339,62,135,.459,.483,41,50,.820,5,62,67,87,21,13,40,71,294
2019,Jrue Holiday,SG,28,NOP,67,67,2402,547,1159,.472,118,363,.325,429,796,.539,.523,208,271,.768,75,259,334,518,109,54,210,148,1420
2019,Justin Holiday,SG,29,TOT,82,77,2607,300,777,.386,162,465,.348,138,312,.442,.490,95,106,.896,46,277,323,146,121,36,104,164,857
2019,John Holland,SF,30,CLE,1,0,1,0,0,,0,0,,0,0,,,0,0,,0,0,0,0,0,0,0,0,0
2019,Rondae Hollis-Jefferson,SF,24,BRK,59,21,1234,200,487,.411,9,49,.184,191,438,.436,.420,118,183,.645,83,227,310,96,44,27,68,107,527
2019,Richaun Holmes,C,25,PHO,70,4,1184,222,365,.608,0,0,,222,365,.608,.608,128,175,.731,115,216,331,60,42,79,52,194,572
2019,Rodney Hood,SG,26,TOT,72,49,1893,292,671,.435,84,236,.356,208,435,.478,.498,137,155,.884,25,132,157,126,59,12,55,146,805
2019,Al Horford,C,32,BOS,68,68,1973,387,723,.535,73,203,.360,314,520,.604,.586,78,95,.821,120,338,458,283,59,86,102,126,925
2019,Danuel House Jr.,SF,25,HOU,39,13,979,118,252,.468,74,178,.416,44,74,.595,.615,56,71,.789,25,115,140,40,21,11,35,80,366
2019,Dwight Howard,C,33,WAS,9,9,230,43,69,.623,0,0,,43,69,.623,.623,29,48,.604,24,59,83,4,7,4,16,34,115
2019,Kevin Huerter,SG,20,ATL,75,59,2048,275,657,.419,136,353,.385,139,304,.457,.522,41,56,.732,60,185,245,214,65,25,109,155,727
2019,Isaac Humphries,C,21,ATL,5,1,56,6,21,.286,3,11,.273,3,10,.300,.357,0,0,,4,7,11,0,1,0,0,7,15
2019,R.J. Hunter,SG,25,BOS,1,0,26,6,13,.462,4,10,.400,2,3,.667,.615,1,2,.500,1,2,3,3,1,0,0,3,17
2019,Chandler Hutchison,SF,22,CHI,44,14,895,96,209,.459,14,50,.280,82,159,.516,.493,23,38,.605,31,154,185,34,23,6,25,59,229
2019,Serge Ibaka,C,29,TOR,74,51,2010,464,877,.529,49,169,.290,415,708,.586,.557,135,177,.763,156,445,601,99,29,103,114,211,1112
2019,Andre Iguodala,SF,35,GSW,68,13,1578,151,302,.500,48,144,.333,103,158,.652,.579,39,67,.582,48,204,252,216,61,51,52,95,389
2019,Ersan İlyasova,PF,31,MIL,67,7,1231,167,381,.438,58,160,.363,109,221,.493,.514,61,74,.824,94,208,302,52,32,20,48,172,453
2019,Joe Ingles,PF,31,UTA,82,82,2568,359,802,.448,189,483,.391,170,319,.533,.565,87,123,.707,35,295,330,469,98,20,193,180,994
2019,Andre Ingram,SG,33,LAL,4,0,15,0,6,.000,0,3,.000,0,3,.000,.000,0,0,,1,1,2,0,1,0,1,0,0
2019,Brandon Ingram,SF,21,LAL,52,52,1760,362,729,.497,31,94,.330,331,635,.521,.518,195,289,.675,41,226,267,154,28,31,129,149,950
2019,Kyrie Irving,PG,26,BOS,67,67,2214,604,1241,.487,174,434,.401,430,807,.533,.557,214,245,.873,71,264,335,464,103,34,172,167,1596
2019,Jonathan Isaac,PF,21,ORL,75,64,1996,262,611,.429,86,266,.323,176,345,.510,.499,110,135,.815,99,312,411,80,59,98,75,143,720
2019,Wes Iwundu,SF,24,ORL,68,13,1233,113,274,.412,29,79,.367,84,195,.431,.465,84,103,.816,37,147,184,73,28,22,44,123,339
2019,Demetrius Jackson,PG,24,PHI,6,0,39,8,15,.533,2,6,.333,6,9,.667,.600,4,4,1.000,2,1,3,5,2,0,1,4,22
2019,Frank Jackson,PG,20,NOP,61,16,1169,194,447,.434,53,169,.314,141,278,.507,.493,54,73,.740,25,109,134,69,25,2,48,92,495
2019,Jaren Jackson Jr.,PF,19,MEM,58,56,1515,298,589,.506,51,142,.359,247,447,.553,.549,151,197,.766,73,199,272,64,52,82,98,220,798
2019,Josh Jackson,SG,21,PHO,79,29,1988,347,841,.413,73,225,.324,274,616,.445,.456,143,213,.671,66,281,347,183,74,56,173,209,910
2019,Justin Jackson,SF,23,TOT,81,14,1614,217,485,.447,87,245,.355,130,240,.542,.537,62,79,.785,44,168,212,96,32,14,29,99,583
2019,Reggie Jackson,PG,28,DET,82,82,2289,441,1047,.421,174,471,.369,267,576,.464,.504,204,236,.864,45,171,216,344,55,9,148,208,1260
2019,LeBron James,SF,34,LAL,55,55,1937,558,1095,.510,111,327,.339,447,768,.582,.560,278,418,.665,57,408,465,454,72,33,197,94,1505
2019,Amile Jefferson,PF,25,ORL,12,0,68,10,16,.625,0,0,,10,16,.625,.625,7,8,.875,6,15,21,3,3,3,1,8,27
2019,John Jenkins,SG,27,TOT,26,0,333,42,105,.400,22,58,.379,20,47,.426,.505,15,18,.833,6,31,37,22,0,2,9,10,121
2019,Jonas Jerebko,PF,31,GSW,73,6,1218,163,355,.459,69,188,.367,94,167,.563,.556,64,80,.800,72,216,288,96,27,18,43,137,459
2019,Alize Johnson,PF,22,IND,14,0,64,4,16,.250,1,2,.500,3,14,.214,.281,4,8,.500,4,15,19,1,1,3,0,7,13
2019,Amir Johnson,C,31,PHI,51,6,529,79,157,.503,12,40,.300,67,117,.573,.541,31,41,.756,47,100,147,60,16,13,45,99,201
2019,B.J. Johnson,SF,23,TOT,7,0,49,9,18,.500,3,7,.429,6,11,.545,.583,2,2,1.000,2,6,8,0,2,0,2,4,23
2019,James Johnson,PF,31,MIA,55,33,1164,164,379,.433,50,149,.336,114,230,.496,.499,50,70,.714,22,154,176,135,35,27,74,114,428
2019,Stanley Johnson,SF,22,TOT,66,7,1208,171,440,.389,62,215,.288,109,225,.484,.459,50,64,.781,34,183,217,88,60,14,81,114,454
2019,Tyler Johnson,PG,26,TOT,57,22,1529,217,526,.413,90,260,.346,127,266,.477,.498,95,127,.748,34,139,173,166,54,27,77,97,619
2019,Wesley Johnson,SF,31,TOT,38,13,534,45,128,.352,25,76,.329,20,52,.385,.449,13,19,.684,12,60,72,23,14,12,18,63,128
2019,Nikola Jokić,C,23,DEN,80,80,2504,616,1206,.511,83,270,.307,533,936,.569,.545,289,352,.821,228,637,865,580,108,55,248,228,1604
2019,Damian Jones,C,23,GSW,24,22,410,53,74,.716,0,0,,53,74,.716,.716,24,37,.649,31,44,75,28,12,25,16,63,130
2019,Derrick Jones Jr.,SF,21,MIA,60,14,1153,160,324,.494,28,91,.308,132,233,.567,.537,74,122,.607,96,144,240,37,46,42,43,123,422
2019,Jalen Jones,SF,25,CLE,16,0,214,26,62,.419,10,28,.357,16,34,.471,.500,19,27,.704,11,23,34,7,9,2,8,27,81
2019,Jemerrio Jones,SF,23,LAL,6,2,143,12,33,.364,2,10,.200,10,23,.435,.394,1,2,.500,16,33,49,13,7,5,5,10,27
2019,Terrence Jones,PF,27,HOU,2,0,5,1,4,.250,0,2,.000,1,2,.500,.250,0,1,.000,0,4,4,0,0,0,1,1,2
2019,Tyus Jones,PG,22,MIN,68,23,1560,185,446,.415,40,126,.317,145,320,.453,.460,58,69,.841,23,111,134,327,81,5,47,78,468
2019,DeAndre Jordan,C,30,TOT,69,69,2047,286,446,.641,0,0,,286,446,.641,.641,186,264,.705,225,677,902,156,42,73,153,167,758
2019,Cory Joseph,PG,27,IND,82,9,2063,226,548,.412,55,171,.322,171,377,.454,.463,30,43,.698,39,240,279,321,94,22,80,131,537
2019,Frank Kaminsky,C,25,CHO,47,0,755,138,298,.463,50,139,.360,88,159,.553,.547,79,107,.738,39,124,163,63,12,12,41,68,405
2019,Luke Kennard,SG,22,DET,63,10,1437,228,520,.438,106,269,.394,122,251,.486,.540,51,61,.836,12,171,183,114,26,10,57,92,613
2019,Michael Kidd-Gilchrist,PF,25,CHO,64,3,1179,158,332,.476,16,47,.340,142,285,.498,.500,95,123,.772,88,158,246,61,32,39,43,156,427
2019,George King,SF,25,PHO,1,0,6,0,0,,0,0,,0,0,,,0,0,,0,1,1,0,0,0,0,0,0
2019,Maxi Kleber,PF,27,DAL,71,18,1502,175,386,.453,77,218,.353,98,168,.583,.553,58,74,.784,90,239,329,70,36,78,54,143,485
2019,Brandon Knight,PG,27,TOT,39,26,736,99,260,.381,41,129,.318,58,131,.443,.460,27,34,.794,10,49,59,71,21,2,30,62,266
2019,Kevin Knox,PF,19,NYK,75,57,2158,338,914,.370,125,364,.343,213,550,.387,.438,162,226,.717,61,274,335,82,43,24,114,175,963
2019,Furkan Korkmaz,SG,21,PHI,48,7,679,98,245,.400,47,144,.326,51,101,.505,.496,36,44,.818,16,91,107,52,29,2,25,62,279
2019,Luke Kornet,PF,23,NYK,46,18,784,107,283,.378,70,193,.363,37,90,.411,.502,38,46,.826,28,107,135,54,27,42,25,41,322
2019,Kyle Korver,SG-PF,37,TOT,70,0,1334,201,483,.416,138,348,.397,63,135,.467,.559,60,73,.822,9,153,162,81,25,12,59,106,600
2019,Kosta Koufos,C,29,SAC,42,1,502,73,153,.477,0,0,,73,153,.477,.477,10,24,.417,52,125,177,36,15,18,27,68,156
2019,Rodions Kurucs,SF,20,BRK,63,46,1294,202,449,.450,58,184,.315,144,265,.543,.514,72,92,.783,56,190,246,52,41,25,77,146,534
2019,Kyle Kuzma,PF,23,LAL,70,68,2314,496,1087,.456,128,422,.303,368,665,.553,.515,188,250,.752,60,322,382,178,41,26,133,170,1308
2019,Skal Labissière,PF,22,TOT,22,1,176,26,49,.531,6,13,.462,20,36,.556,.592,9,17,.529,9,34,43,11,5,6,11,29,67
2019,Jeremy Lamb,SG,26,CHO,79,55,2250,431,979,.440,115,330,.348,316,649,.487,.499,231,260,.888,65,369,434,172,88,32,80,140,1208
2019,Zach LaVine,SG,23,CHI,63,62,2171,530,1135,.467,120,321,.374,410,814,.504,.520,312,375,.832,40,254,294,283,60,26,215,140,1492
2019,Jake Layman,SF,24,POR,71,33,1327,216,424,.509,59,181,.326,157,243,.646,.579,50,71,.704,56,161,217,53,31,30,46,116,541
2019,T.J. Leaf,PF,21,IND,58,1,522,99,183,.541,8,31,.258,91,152,.599,.563,19,31,.613,43,82,125,24,9,19,12,35,225
2019,Courtney Lee,SG,33,TOT,34,6,428,53,129,.411,16,55,.291,37,74,.500,.473,14,21,.667,9,45,54,37,21,3,14,32,136
2019,Damion Lee,SG,26,GSW,32,0,375,56,127,.441,27,68,.397,29,59,.492,.547,19,22,.864,8,56,64,13,13,0,11,28,158
2019,Walt Lemon Jr.,PG,26,CHI,6,3,167,38,87,.437,2,5,.400,36,82,.439,.448,8,11,.727,4,23,27,30,11,1,10,14,86
2019,Alex Len,C,25,ATL,77,31,1544,320,648,.494,74,204,.363,246,444,.554,.551,140,216,.648,158,266,424,86,27,69,97,200,854
2019,Kawhi Leonard,SF,27,TOR,60,60,2040,560,1129,.496,112,302,.371,448,827,.542,.546,364,426,.854,78,361,439,199,106,24,121,87,1596
2019,Meyers Leonard,C,26,POR,61,2,878,132,242,.545,50,111,.450,82,131,.626,.649,43,51,.843,49,184,233,75,13,9,43,105,357
2019,Jon Leuer,PF,29,DET,41,1,402,66,113,.584,1,11,.091,65,102,.637,.588,23,31,.742,27,70,97,14,12,4,23,60,156
2019,Caris LeVert,SF,24,BRK,40,25,1063,207,483,.429,48,154,.312,159,329,.483,.478,85,123,.691,35,116,151,156,42,14,69,77,547
2019,Damian Lillard,PG,28,POR,80,80,2838,681,1533,.444,237,643,.369,444,890,.499,.522,468,513,.912,68,303,371,551,88,34,212,148,2067
2019,Jeremy Lin,PG,30,TOT,74,4,1436,238,541,.440,55,187,.294,183,354,.517,.491,176,210,.838,22,157,179,231,47,13,124,144,707
2019,Shaun Livingston,PG,33,GSW,64,0,967,109,210,.519,0,2,.000,109,208,.524,.519,40,51,.784,42,75,117,114,31,27,38,74,258
2019,Zach Lofton,SG,26,DET,1,0,4,0,1,.000,0,1,.000,0,0,,.000,0,0,,0,0,0,0,1,0,1,0,0
2019,Kevon Looney,C,22,GSW,80,24,1481,217,347,.625,1,10,.100,216,337,.641,.627,65,105,.619,194,223,417,123,46,53,51,211,500
2019,Brook Lopez,C,30,MIL,81,81,2322,355,786,.452,187,512,.365,168,274,.613,.571,112,133,.842,33,363,396,98,51,179,82,189,1009
2019,Robin Lopez,C,30,CHI,74,36,1606,304,535,.568,7,31,.226,297,504,.589,.575,89,123,.724,140,146,286,89,11,78,96,124,704
2019,Kevin Love,PF,30,CLE,22,21,598,109,283,.385,53,147,.361,56,136,.412,.479,103,114,.904,33,206,239,48,6,5,42,54,374
2019,Kyle Lowry,PG,32,TOR,65,65,2213,304,739,.411,157,453,.347,147,286,.514,.518,161,194,.830,41,271,312,564,91,31,182,166,926
2019,Jordan Loyd,PG,25,TOR,12,0,55,8,18,.444,4,8,.500,4,10,.400,.556,9,11,.818,1,8,9,6,0,0,2,5,29
2019,Kalin Lucas,PG,29,DET,1,0,6,0,1,.000,0,1,.000,0,0,,.000,2,2,1.000,0,3,3,1,0,0,0,1,2
2019,Timothé Luwawu-Cabarrot,SF,23,TOT,50,7,669,82,218,.376,36,116,.310,46,102,.451,.459,31,41,.756,11,86,97,26,19,8,21,73,231
2019,Tyler Lydon,PF,22,DEN,25,0,94,9,18,.500,4,10,.400,5,8,.625,.611,1,3,.333,7,11,18,6,2,0,4,10,23
2019,Trey Lyles,PF,23,DEN,64,2,1120,207,495,.418,51,200,.255,156,295,.529,.470,81,116,.698,44,202,246,87,30,23,68,93,546
2019,Scott Machado,PG,28,LAL,4,0,19,4,6,.667,1,1,1.000,3,5,.600,.750,1,1,1.000,0,0,0,3,1,0,0,2,10
2019,Shelvin Mack,PG,28,TOT,57,3,1246,163,403,.404,46,130,.354,117,273,.429,.462,58,84,.690,18,86,104,183,47,4,66,84,430
2019,Daryl Macon,SG,23,DAL,8,0,90,10,27,.370,5,11,.455,5,16,.313,.463,4,7,.571,2,10,12,7,1,0,6,8,29
2019,J.P. Macura,SG,23,CHO,2,0,17,3,9,.333,0,4,.000,3,5,.600,.333,0,0,,0,3,3,2,0,0,0,0,6
2019,Ian Mahinmi,C,32,WAS,34,6,498,47,104,.452,3,16,.188,44,88,.500,.466,42,61,.689,48,80,128,25,25,16,21,84,139
2019,Thon Maker,C-PF,21,TOT,64,5,972,109,268,.407,49,153,.320,60,115,.522,.498,56,84,.667,41,161,202,45,21,51,33,105,323
2019,Boban Marjanović,C,30,TOT,58,12,681,160,260,.615,4,10,.400,156,250,.624,.623,98,131,.748,87,178,265,54,16,27,59,90,422
2019,Lauri Markkanen,PF,21,CHI,52,51,1682,342,795,.430,120,332,.361,222,463,.479,.506,170,195,.872,74,396,470,75,37,33,85,122,974
2019,Jarell Martin,PF,24,ORL,42,1,328,43,104,.413,20,57,.351,23,47,.489,.510,9,11,.818,11,62,73,18,3,8,11,51,115
2019,Frank Mason III,PG,24,SAC,38,0,435,71,169,.420,14,64,.219,57,105,.543,.462,39,57,.684,6,37,43,84,16,4,36,34,195
2019,Yante Maten,PF,22,MIA,2,0,13,1,4,.250,0,1,.000,1,3,.333,.250,0,0,,1,2,3,0,1,0,0,0,2
2019,Wesley Matthews,SF-SG,32,TOT,69,68,2091,279,698,.400,150,403,.372,129,295,.437,.507,132,163,.810,32,138,170,160,54,17,91,160,840
2019,Luc Mbah a Moute,PF,32,LAC,4,0,61,8,18,.444,2,6,.333,6,12,.500,.500,2,5,.400,2,5,7,2,1,1,2,8,20
2019,Tahjere McCall,SG,24,BRK,1,0,8,2,3,.667,0,1,.000,2,2,1.000,.667,0,1,.000,0,1,1,0,0,0,0,2,4
2019,Patrick McCaw,SG,23,TOT,29,1,397,26,63,.413,9,28,.321,17,35,.486,.484,13,15,.867,7,41,48,29,23,2,17,38,74
2019,CJ McCollum,SG,27,POR,70,70,2375,571,1243,.459,167,445,.375,404,798,.506,.527,159,192,.828,62,220,282,207,55,28,106,172,1468
2019,T.J. McConnell,PG,26,PHI,76,3,1470,220,419,.525,14,42,.333,206,377,.546,.542,29,37,.784,28,146,174,258,79,17,91,105,483
2019,Doug McDermott,SF,27,IND,77,1,1340,207,422,.491,84,206,.408,123,216,.569,.590,66,79,.835,17,92,109,67,18,8,42,104,564
2019,JaVale McGee,C,31,LAL,75,62,1671,400,641,.624,1,12,.083,399,629,.634,.625,96,152,.632,195,371,566,52,47,148,108,208,897
2019,Rodney McGruder,SG,27,MIA,66,45,1550,186,461,.403,79,225,.351,107,236,.453,.489,52,72,.722,60,178,238,112,36,12,64,115,503
2019,Alfonzo McKinnie,SF,26,GSW,72,5,1003,134,275,.487,42,118,.356,92,157,.586,.564,27,48,.563,81,166,247,31,18,15,30,134,337
2019,Ben McLemore,SG,25,SAC,19,0,158,25,64,.391,17,41,.415,8,23,.348,.523,8,12,.667,3,14,17,4,6,3,5,22,75
2019,Jordan McRae,SG,27,WAS,27,0,333,61,130,.469,10,35,.286,51,95,.537,.508,28,35,.800,6,34,40,30,13,7,15,26,160
2019,Jodie Meeks,SG,31,TOR,8,0,104,21,39,.538,8,18,.444,13,21,.619,.641,1,1,1.000,1,11,12,8,1,1,2,5,51
2019,Salah Mejri,C,32,DAL,36,4,399,55,112,.491,11,34,.324,44,78,.564,.540,20,32,.625,36,95,131,35,10,26,21,55,141
2019,De'Anthony Melton,PG,20,PHO,50,31,984,100,256,.391,29,95,.305,71,161,.441,.447,21,28,.750,25,109,134,159,68,23,75,113,250
2019,Chimezie Metu,PF,21,SAS,29,0,145,19,58,.328,0,2,.000,19,56,.339,.328,13,17,.765,9,27,36,13,6,2,15,14,51
2019,Khris Middleton,SF,27,MIL,77,77,2393,506,1148,.441,179,474,.378,327,674,.485,.519,216,258,.837,50,411,461,331,80,7,174,172,1407
2019,C.J. Miles,SF,31,TOT,53,1,856,112,311,.360,67,203,.330,45,108,.417,.468,48,58,.828,13,82,95,36,26,15,30,79,339
2019,Darius Miller,SF,28,NOP,69,15,1757,189,484,.390,133,364,.365,56,120,.467,.528,56,71,.789,14,114,128,146,40,23,59,165,567
2019,Malcolm Miller,SF,25,TOR,10,0,67,11,26,.423,10,21,.476,1,5,.200,.615,3,4,.750,1,4,5,1,1,1,1,5,35
2019,Patty Mills,PG,30,SAS,82,1,1908,282,663,.425,159,404,.394,123,259,.475,.545,88,103,.854,24,158,182,245,49,10,93,129,811
2019,Paul Millsap,PF,33,DEN,70,65,1895,322,665,.484,58,159,.365,264,506,.522,.528,181,249,.727,153,352,505,141,83,54,95,183,883
2019,Shake Milton,SG,22,PHI,20,0,268,34,87,.391,14,44,.318,20,43,.465,.471,5,7,.714,9,26,35,18,8,8,6,29,87
2019,Nikola Mirotić,PF,27,TOT,46,25,1245,238,542,.439,116,318,.365,122,224,.545,.546,105,124,.847,60,279,339,55,31,34,48,107,697
2019,Donovan Mitchell,SG,22,UTA,77,77,2598,661,1530,.432,188,519,.362,473,1011,.468,.493,319,396,.806,59,257,316,322,106,31,218,208,1829
2019,Naz Mitrou-Long,SG,25,UTA,14,0,84,6,20,.300,2,11,.182,4,9,.444,.350,2,2,1.000,1,5,6,15,1,1,8,10,16
2019,Malik Monk,SG,20,CHO,73,0,1258,227,586,.387,109,330,.330,118,256,.461,.480,90,102,.882,16,121,137,117,37,19,86,106,653
2019,Greg Monroe,C,28,TOT,43,2,480,92,189,.487,1,5,.200,91,184,.495,.489,45,72,.625,67,105,172,24,14,8,32,66,230
2019,E'Twaun Moore,SG,29,NOP,53,36,1463,256,532,.481,76,176,.432,180,356,.506,.553,45,59,.763,35,92,127,102,40,8,59,112,633
2019,Eric Moreland,PF,27,TOT,5,0,43,3,7,.429,1,1,1.000,2,6,.333,.500,0,0,,4,16,20,4,1,1,5,9,7
2019,Jaylen Morris,SG,23,MIL,4,0,29,4,10,.400,1,3,.333,3,7,.429,.450,1,2,.500,0,5,5,4,2,0,1,1,10
2019,Marcus Morris,PF,29,BOS,75,53,2091,377,844,.447,146,389,.375,231,455,.508,.533,146,173,.844,76,382,458,109,43,25,92,181,1046
2019,Markieff Morris,PF,29,TOT,58,16,1270,204,484,.421,68,203,.335,136,281,.484,.492,71,92,.772,61,204,265,79,36,22,54,175,547
2019,Monte Morris,PG,23,DEN,82,6,1970,346,702,.493,94,227,.414,252,475,.531,.560,65,81,.802,35,159,194,297,73,4,52,102,851
2019,Donatas Motiejūnas,PF,28,SAS,3,0,13,3,6,.500,0,0,,3,6,.500,.500,0,2,.000,2,1,3,1,0,1,3,6,6
2019,Johnathan Motley,PF,23,LAC,22,0,156,39,73,.534,0,3,.000,39,70,.557,.534,24,40,.600,18,33,51,11,5,3,16,27,102
2019,Emmanuel Mudiay,PG,22,NYK,59,42,1607,330,740,.446,69,210,.329,261,530,.492,.493,144,186,.774,33,163,196,228,43,19,140,103,873
2019,Jamal Murray,PG,21,DEN,75,74,2447,513,1173,.437,152,414,.367,361,759,.476,.502,189,223,.848,65,252,317,363,67,27,158,153,1367
2019,Džanan Musa,SG,19,BRK,9,0,39,9,22,.409,1,10,.100,8,12,.667,.432,0,2,.000,1,4,5,2,2,0,4,1,19
2019,Mike Muscala,PF,27,TOT,64,10,1306,145,361,.402,89,256,.348,56,105,.533,.525,70,85,.824,57,187,244,76,22,38,48,130,449
2019,Svi Mykhailiuk,SF,21,TOT,42,0,440,46,140,.329,29,89,.326,17,51,.333,.432,12,20,.600,9,27,36,37,14,1,21,25,133
2019,Abdel Nader,SF,25,OKC,61,1,694,91,215,.423,32,100,.320,59,115,.513,.498,27,36,.750,14,102,116,20,20,12,26,68,241
2019,Larry Nance Jr.,C,26,CLE,67,30,1795,249,479,.520,33,98,.337,216,381,.567,.554,96,134,.716,168,384,552,214,100,40,97,192,627
2019,Shabazz Napier,PG,27,BRK,56,2,983,169,435,.389,76,228,.333,93,207,.449,.476,115,138,.833,18,82,100,143,41,16,66,67,529
2019,Raul Neto,PG,26,UTA,37,1,474,74,161,.460,20,60,.333,54,101,.535,.522,28,33,.848,6,56,62,93,14,4,35,49,196
2019,Georges Niang,PF,25,UTA,59,0,516,86,181,.475,43,105,.410,43,76,.566,.594,20,24,.833,11,76,87,35,10,6,23,57,235
2019,Joakim Noah,C,33,MEM,42,1,693,110,213,.516,0,1,.000,110,212,.519,.516,78,109,.716,58,180,238,89,20,31,50,96,298
2019,Nerlens Noel,C,24,OKC,77,2,1055,162,276,.587,0,0,,162,276,.587,.587,54,79,.684,127,198,325,45,66,96,48,166,378
2019,Dirk Nowitzki,PF,40,DAL,51,20,795,135,376,.359,64,205,.312,71,171,.415,.444,39,50,.780,5,153,158,35,9,18,18,76,373
2019,Frank Ntilikina,PG,20,NYK,43,16,904,95,282,.337,33,115,.287,62,167,.371,.395,23,30,.767,12,75,87,121,30,14,56,104,246
2019,James Nunnally,SF,28,TOT,15,0,102,12,34,.353,8,25,.320,4,9,.444,.471,4,4,1.000,0,5,5,7,1,0,1,10,36
2019,Jusuf Nurkić,C,24,POR,72,72,1974,420,826,.508,3,29,.103,417,797,.523,.510,282,365,.773,243,505,748,233,71,103,168,250,1125
2019,David Nwaba,SF,26,CLE,51,14,984,126,262,.481,24,75,.320,102,187,.545,.527,58,85,.682,41,122,163,54,36,17,29,106,334
2019,Royce O'Neale,SF,25,UTA,82,16,1671,163,343,.475,68,176,.386,95,167,.569,.574,32,42,.762,22,263,285,124,54,24,70,172,426
2019,Kyle O'Quinn,C,28,IND,45,3,371,69,136,.507,1,12,.083,68,124,.548,.511,17,21,.810,29,90,119,56,9,25,31,68,156
2019,Semi Ojeleye,PF,24,BOS,56,3,594,67,158,.424,28,89,.315,39,69,.565,.513,24,39,.615,24,62,86,23,10,4,19,43,186
2019,Jahlil Okafor,C,23,NOP,59,24,935,212,362,.586,1,5,.200,211,357,.591,.587,59,89,.663,82,196,278,40,15,40,52,96,484
2019,Elie Okobo,PG,21,PHO,53,16,958,114,290,.393,39,132,.295,75,158,.475,.460,37,47,.787,12,86,98,127,32,7,69,109,304
2019,Josh Okogie,SG,20,MIN,74,52,1757,196,508,.386,60,215,.279,136,293,.464,.445,118,162,.728,41,177,218,91,88,33,63,166,570
2019,Victor Oladipo,SG,26,IND,36,36,1147,249,588,.423,74,216,.343,175,372,.470,.486,103,141,.730,21,181,202,186,60,11,82,72,675
2019,Kelly Olynyk,PF,27,MIA,79,36,1812,261,564,.463,113,319,.354,148,245,.604,.563,152,185,.822,72,303,375,140,53,37,114,183,787
2019,Cedi Osman,SF,23,CLE,76,75,2444,360,844,.427,130,374,.348,230,470,.489,.504,141,181,.779,45,312,357,195,60,11,114,195,991
2019,Kelly Oubre Jr.,SF,23,TOT,69,19,1935,375,842,.445,108,338,.320,267,504,.530,.510,189,244,.775,71,254,325,84,84,59,103,181,1047
2019,Zaza Pachulia,C,34,DET,68,3,878,85,193,.440,0,4,.000,85,189,.450,.440,97,124,.782,99,166,265,91,31,17,57,151,267
2019,Jabari Parker,PF,23,TOT,64,17,1724,369,749,.493,61,195,.313,308,554,.556,.533,131,184,.712,79,342,421,152,46,30,151,145,930
2019,Tony Parker,PG,36,CHO,56,0,1003,213,463,.460,13,51,.255,200,412,.485,.474,91,124,.734,14,69,83,207,21,7,75,53,530
2019,Chandler Parsons,SF,30,MEM,25,3,496,68,182,.374,29,94,.309,39,88,.443,.453,22,25,.880,4,66,70,43,19,5,32,45,187
2019,Patrick Patterson,PF,29,OKC,63,5,861,82,219,.374,46,137,.336,36,82,.439,.479,19,30,.633,42,105,147,31,16,13,22,46,229
2019,Justin Patton,C,21,PHI,3,0,21,2,7,.286,0,2,.000,2,5,.400,.286,1,2,.500,2,4,6,3,2,0,0,5,5
2019,Chris Paul,PG,33,HOU,58,58,1857,302,720,.419,127,355,.358,175,365,.479,.508,175,203,.862,36,229,265,473,114,18,152,146,906
2019,Cameron Payne,PG,24,TOT,40,13,712,96,223,.430,25,84,.298,71,139,.511,.487,33,41,.805,13,59,72,106,28,9,45,64,250
2019,Elfrid Payton,PG,24,NOP,42,42,1250,179,412,.434,33,105,.314,146,307,.476,.475,55,74,.743,49,171,220,320,44,17,112,81,446
2019,Gary Payton II,PG,26,WAS,3,0,16,5,8,.625,1,2,.500,4,6,.667,.688,0,0,,1,1,2,4,3,1,1,2,11
2019,Theo Pinson,SG,23,BRK,18,0,211,25,73,.342,12,46,.261,13,27,.481,.425,19,22,.864,4,32,36,21,6,0,18,15,81
2019,Mason Plumlee,C,28,DEN,82,17,1731,262,442,.593,2,10,.200,260,432,.602,.595,111,198,.561,165,359,524,243,66,76,126,252,637
2019,Miles Plumlee,C,30,ATL,18,0,173,32,48,.667,0,0,,32,48,.667,.667,16,30,.533,16,23,39,17,6,4,10,14,80
2019,Jakob Poeltl,C,23,SAS,77,24,1273,187,290,.645,0,0,,187,290,.645,.645,49,92,.533,178,232,410,93,29,68,48,124,423
2019,Quincy Pondexter,SF,30,SAS,53,0,292,29,58,.500,6,18,.333,23,40,.575,.552,34,42,.810,8,38,46,24,11,1,13,24,98
2019,Otto Porter Jr.,SF,25,TOT,56,43,1683,299,643,.465,104,256,.406,195,387,.504,.546,78,96,.813,54,260,314,120,82,31,65,108,780
2019,Bobby Portis,PF,23,TOT,50,28,1299,279,628,.444,75,191,.393,204,437,.467,.504,77,97,.794,109,294,403,72,35,20,74,145,710
2019,Dwight Powell,C,27,DAL,77,22,1662,290,486,.597,39,127,.307,251,359,.699,.637,196,254,.772,140,271,411,112,44,50,67,201,815
2019,Norman Powell,SG,25,TOR,60,3,1126,193,400,.483,68,170,.400,125,230,.543,.568,62,75,.827,16,123,139,91,39,13,65,96,516
2019,Alex Poythress,PF,25,ATL,21,1,305,40,81,.494,9,23,.391,31,58,.534,.549,18,29,.621,29,47,76,17,4,10,13,47,107
2019,Taurean Prince,SF,24,ATL,55,47,1552,262,594,.441,123,315,.390,139,279,.498,.545,95,116,.819,22,177,199,118,53,19,100,141,742
2019,Zhou Qi,PF,23,HOU,1,0,1,1,1,1.000,0,0,,1,1,1.000,1.000,0,0,,0,0,0,0,0,0,0,0,2
2019,Ivan Rabb,PF,21,MEM,49,13,721,116,212,.547,3,15,.200,113,197,.574,.554,49,69,.710,70,136,206,54,17,14,35,90,284
2019,Chasson Randle,PG,25,WAS,49,2,743,91,217,.419,46,115,.400,45,102,.441,.525,43,62,.694,10,46,56,97,25,3,43,91,271
2019,Julius Randle,PF,24,NOP,73,49,2232,571,1089,.524,67,195,.344,504,894,.564,.555,356,487,.731,162,472,634,229,52,45,208,246,1565
2019,J.J. Redick,SG,34,PHI,76,63,2379,452,1027,.440,240,605,.397,212,422,.502,.557,228,255,.894,20,166,186,206,32,17,101,129,1372
2019,Davon Reed,SG,23,IND,10,0,47,5,12,.417,2,4,.500,3,8,.375,.500,0,0,,2,4,6,3,1,0,1,3,12
2019,Cameron Reynolds,SG,23,MIN,19,0,259,33,78,.423,21,51,.412,12,27,.444,.558,8,9,.889,4,27,31,13,6,2,5,26,95
2019,Josh Richardson,SG,25,MIA,73,73,2539,423,1026,.412,164,460,.357,259,566,.458,.492,199,231,.861,54,209,263,298,79,34,113,200,1209
2019,Malachi Richardson,SG,23,TOR,22,0,103,9,29,.310,8,25,.320,1,4,.250,.448,4,5,.800,2,11,13,0,1,0,8,13,30
2019,Austin Rivers,SG,26,TOT,76,15,2028,232,572,.406,104,327,.318,128,245,.522,.497,50,95,.526,25,137,162,167,47,23,68,207,618
2019,Devin Robinson,SF,23,WAS,7,0,95,19,32,.594,0,2,.000,19,30,.633,.594,9,14,.643,6,14,20,6,4,6,2,11,47
2019,Duncan Robinson,SF,24,MIA,15,1,161,18,46,.391,10,35,.286,8,11,.727,.500,4,6,.667,2,17,19,5,5,0,4,11,50
2019,Glenn Robinson III,SF,25,DET,47,18,610,74,176,.420,18,62,.290,56,114,.491,.472,32,40,.800,17,54,71,21,14,8,18,45,198
2019,Jerome Robinson,SG,21,LAC,33,0,320,44,110,.400,18,57,.316,26,53,.491,.482,6,9,.667,3,38,41,19,11,3,13,46,112
2019,Mitchell Robinson,C,20,NYK,66,19,1360,202,291,.694,0,0,,202,291,.694,.694,81,135,.600,177,246,423,37,52,161,35,217,485
2019,Rajon Rondo,PG,32,LAL,46,29,1369,175,432,.405,51,142,.359,124,290,.428,.464,23,36,.639,34,209,243,367,57,7,127,100,424
2019,Derrick Rose,PG,30,MIN,51,13,1392,363,753,.482,54,146,.370,309,607,.509,.518,137,160,.856,33,107,140,220,31,12,82,57,917
2019,Terrence Ross,SG,27,ORL,81,0,2150,440,1027,.428,217,566,.383,223,461,.484,.534,126,144,.875,27,253,280,135,72,29,90,119,1223
2019,Terry Rozier,PG,24,BOS,79,14,1791,258,666,.387,119,337,.353,139,329,.422,.477,73,93,.785,32,275,307,231,68,21,68,101,708
2019,Ricky Rubio,PG,28,UTA,68,67,1899,295,730,.404,79,254,.311,216,476,.454,.458,195,228,.855,33,210,243,416,91,10,180,180,864
2019,D'Angelo Russell,PG,22,BRK,81,81,2448,659,1517,.434,234,635,.369,425,882,.482,.512,160,205,.780,53,262,315,563,100,20,253,141,1712
2019,Domantas Sabonis,C,22,IND,74,5,1838,413,700,.590,9,17,.529,404,683,.592,.596,208,291,.715,186,504,690,212,48,30,160,239,1043
2019,Brandon Sampson,SG,21,CHI,14,2,214,28,60,.467,11,29,.379,17,31,.548,.558,4,6,.667,3,13,16,10,8,3,12,19,71
2019,JaKarr Sampson,SF,25,CHI,4,0,127,29,54,.537,5,14,.357,24,40,.600,.583,17,21,.810,5,27,32,4,4,3,4,8,80
2019,Dario Šarić,PF,24,TOT,81,41,2023,304,696,.437,118,323,.365,186,373,.499,.522,132,150,.880,126,331,457,127,45,9,97,182,858
2019,Tomáš Satoranský,PG,27,WAS,80,54,2164,257,530,.485,64,162,.395,193,368,.524,.545,131,160,.819,82,197,279,399,82,13,120,172,709
2019,Dennis Schröder,PG,25,OKC,79,14,2314,457,1104,.414,124,364,.341,333,740,.450,.470,186,227,.819,38,246,284,323,65,12,172,189,1224
2019,Mike Scott,PF,30,TOT,79,3,1395,168,420,.400,101,252,.401,67,168,.399,.520,22,33,.667,43,233,276,66,26,13,44,156,459
2019,Thabo Sefolosha,SF,34,UTA,50,2,609,71,149,.477,34,78,.436,37,71,.521,.591,14,22,.636,8,115,123,27,43,5,25,41,190
2019,Wayne Selden,SG,24,TOT,75,13,1439,196,483,.406,55,174,.316,141,309,.456,.463,67,92,.728,37,143,180,109,33,13,79,131,514
2019,Collin Sexton,PG,20,CLE,82,72,2605,519,1206,.430,119,296,.402,400,910,.440,.480,214,255,.839,57,179,236,243,44,6,185,186,1371
2019,Landry Shamet,SG,21,TOT,79,27,1802,240,557,.431,167,396,.422,73,161,.453,.581,75,93,.806,21,113,134,117,37,10,45,155,722
2019,Iman Shumpert,SG,28,TOT,62,41,1481,167,446,.374,95,273,.348,72,173,.416,.481,36,45,.800,27,156,183,112,59,24,50,127,465
2019,Pascal Siakam,PF,24,TOR,80,79,2548,519,945,.549,79,214,.369,440,731,.602,.591,237,302,.785,124,425,549,248,73,52,154,241,1354
2019,Jordan Sibert,SG,26,ATL,1,0,4,1,1,1.000,1,1,1.000,0,0,,1.500,0,0,,0,0,0,0,0,0,0,0,3
2019,Ben Simmons,PG,22,PHI,79,79,2700,540,960,.563,0,6,.000,540,954,.566,.563,257,428,.600,172,525,697,610,112,61,274,209,1337
2019,Jonathon Simmons,SG-SF,29,TOT,56,9,1064,133,350,.380,28,104,.269,105,246,.427,.420,72,97,.742,27,99,126,128,29,15,68,89,366
2019,Kobi Simmons,PG,21,CLE,1,0,2,0,0,,0,0,,0,0,,,0,0,,0,0,0,0,0,0,0,0,0
2019,Anfernee Simons,SG,19,POR,20,1,141,28,63,.444,10,29,.345,18,34,.529,.524,9,16,.563,3,10,13,13,1,0,11,9,75
2019,Marcus Smart,SG,24,BOS,80,60,2200,239,567,.422,126,346,.364,113,221,.511,.533,104,129,.806,57,177,234,321,143,28,123,201,708
2019,Dennis Smith Jr.,PG,21,TOT,53,50,1508,278,650,.428,67,208,.322,211,442,.477,.479,99,156,.635,32,123,155,252,67,20,154,129,722
2019,Ish Smith,PG,30,DET,56,0,1251,205,489,.419,44,135,.326,161,354,.455,.464,47,62,.758,23,122,145,203,28,11,61,109,501
2019,J.R. Smith,SG,33,CLE,11,4,222,27,79,.342,12,39,.308,15,40,.375,.418,8,10,.800,0,18,18,21,11,3,11,19,74
2019,Jason Smith,PF-C,32,TOT,20,1,190,21,59,.356,9,26,.346,12,33,.364,.432,14,16,.875,16,36,52,14,3,7,13,30,65
2019,Zhaire Smith,SG,19,PHI,6,2,111,14,34,.412,6,16,.375,8,18,.444,.500,6,8,.750,3,10,13,10,2,2,6,8,40
2019,Tony Snell,SF,27,MIL,74,12,1304,163,361,.452,81,204,.397,82,157,.522,.564,37,42,.881,29,128,157,68,26,18,23,90,444
2019,Ray Spalding,PF,21,TOT,14,3,148,25,47,.532,0,3,.000,25,44,.568,.532,4,12,.333,15,33,48,5,9,8,9,23,54
2019,Omari Spellman,PF,21,ATL,46,11,805,98,244,.402,44,128,.344,54,116,.466,.492,32,45,.711,72,122,194,47,26,25,31,67,272
2019,Nik Stauskas,SG,25,TOT,68,0,1015,136,338,.402,70,188,.372,66,150,.440,.506,57,64,.891,18,109,127,81,21,7,51,50,399
2019,D.J. Stephens,SG,28,MEM,1,0,7,1,2,.500,0,0,,1,2,.500,.500,0,0,,0,0,0,0,1,0,1,0,2
2019,Lance Stephenson,SG,28,LAL,68,3,1123,184,432,.426,73,197,.371,111,235,.472,.510,50,73,.685,32,183,215,140,41,7,86,111,491
2019,Edmond Sumner,PG,23,IND,23,2,210,22,64,.344,7,27,.259,15,37,.405,.398,15,24,.625,9,15,24,10,12,5,10,26,66
2019,Caleb Swanigan,PF,21,TOT,21,0,178,18,53,.340,1,7,.143,17,46,.370,.349,6,9,.667,17,47,64,11,6,1,18,28,43
2019,Jayson Tatum,SF,20,BOS,79,79,2455,466,1036,.450,116,311,.373,350,725,.483,.506,195,228,.855,70,407,477,168,84,57,122,168,1243
2019,Jeff Teague,PG,30,MIN,42,41,1264,176,416,.423,35,105,.333,141,311,.453,.465,123,153,.804,16,90,106,343,43,18,97,90,510
2019,Garrett Temple,SG,32,TOT,75,55,2040,208,493,.422,90,264,.341,118,229,.515,.513,80,107,.748,28,188,216,106,76,30,70,204,586
2019,Miloš Teodosić,PG,31,LAC,15,0,150,17,40,.425,10,27,.370,7,13,.538,.550,4,7,.571,3,13,16,32,3,1,21,27,48
2019,Jared Terrell,SG,23,MIN,14,0,111,12,39,.308,4,17,.235,8,22,.364,.359,3,6,.500,1,5,6,12,3,2,10,16,31
2019,Emanuel Terry,PF,22,TOT,3,0,23,4,7,.571,0,0,,4,7,.571,.571,2,4,.500,3,4,7,2,3,0,2,4,10
2019,Daniel Theis,C,26,BOS,66,2,908,146,266,.549,26,67,.388,120,199,.603,.598,56,76,.737,87,138,225,68,21,42,33,161,374
2019,Isaiah Thomas,SG,29,DEN,12,0,181,34,99,.343,12,43,.279,22,56,.393,.404,17,27,.630,5,8,13,23,5,1,18,17,97
2019,Khyri Thomas,SG,22,DET,26,0,195,22,69,.319,10,35,.286,12,34,.353,.391,7,11,.636,4,16,20,8,7,5,4,22,61
2019,Lance Thomas,PF,30,NYK,46,17,783,78,197,.396,22,79,.278,56,118,.475,.452,27,36,.750,21,96,117,27,17,7,24,83,205
2019,Klay Thompson,SG,28,GSW,78,78,2652,655,1402,.467,241,599,.402,414,803,.516,.553,129,158,.816,37,262,299,186,84,47,115,157,1680
2019,Tristan Thompson,C,27,CLE,43,40,1198,201,380,.529,0,0,,201,380,.529,.529,68,106,.642,173,265,438,86,28,16,59,89,470
2019,Sindarius Thornwell,SG,24,LAC,64,1,313,17,49,.347,3,15,.200,14,34,.412,.378,25,34,.735,5,39,44,18,14,7,20,41,62
2019,Anthony Tolliver,PF,33,MIN,65,0,1079,99,259,.382,81,215,.377,18,44,.409,.539,47,60,.783,15,162,177,46,17,21,36,91,326
2019,Karl-Anthony Towns,C,23,MIN,77,77,2545,681,1314,.518,142,355,.400,539,959,.562,.572,376,450,.836,263,691,954,259,67,125,240,292,1880
2019,Gary Trent Jr.,SG,20,POR,15,1,111,16,50,.320,5,21,.238,11,29,.379,.370,3,7,.429,1,10,11,5,1,2,4,4,40
2019,Allonzo Trier,SG,23,NYK,64,3,1459,232,518,.448,52,132,.394,180,386,.466,.498,179,223,.803,31,166,197,119,28,14,116,117,695
2019,P.J. Tucker,PF,33,HOU,82,82,2802,207,523,.396,146,387,.377,61,136,.449,.535,41,59,.695,121,358,479,96,132,39,63,252,601
2019,Evan Turner,PG,30,POR,73,2,1605,204,443,.460,11,52,.212,193,391,.494,.473,75,106,.708,37,291,328,283,33,18,114,110,494
2019,Myles Turner,C,22,IND,74,74,2119,380,780,.487,76,196,.388,304,584,.521,.536,148,201,.736,101,430,531,115,60,199,100,195,984
2019,Ekpe Udoh,C,31,UTA,51,1,320,50,72,.694,0,0,,50,72,.694,.694,19,30,.633,27,63,90,28,10,31,13,36,119
2019,Tyler Ulis,PG,23,CHI,1,0,1,0,0,,0,0,,0,0,,,0,0,,0,0,0,0,0,0,0,0,0
2019,Jonas Valančiūnas,C,26,TOT,49,27,1091,301,538,.559,14,48,.292,287,490,.586,.572,147,185,.795,106,313,419,70,19,53,90,146,763
2019,Jarred Vanderbilt,PF,19,DEN,17,0,69,9,19,.474,0,1,.000,9,18,.500,.474,6,10,.600,7,16,23,3,6,1,8,8,24
2019,Fred VanVleet,PG,24,TOR,64,28,1760,246,600,.410,112,296,.378,134,304,.441,.503,97,115,.843,21,146,167,307,57,20,82,110,701
2019,Noah Vonleh,PF,23,NYK,68,57,1722,207,440,.470,46,137,.336,161,303,.531,.523,111,156,.712,113,415,528,129,46,51,88,174,571
2019,Nikola Vučević,C,28,ORL,80,80,2510,701,1354,.518,84,231,.364,617,1123,.549,.549,179,227,.789,224,736,960,307,81,89,159,157,1665
2019,Dwyane Wade,SG,37,MIA,72,2,1885,416,960,.433,86,261,.330,330,699,.472,.478,165,233,.708,69,216,285,301,59,38,166,118,1083
2019,Moritz Wagner,C,21,LAL,43,5,446,71,171,.415,22,77,.286,49,94,.521,.480,43,53,.811,17,68,85,24,11,13,39,57,207
2019,Dion Waiters,SG,27,MIA,44,28,1138,198,478,.414,109,289,.377,89,189,.471,.528,22,44,.500,7,109,116,121,29,9,64,72,527
2019,Kemba Walker,PG,28,CHO,82,82,2863,731,1684,.434,260,731,.356,471,953,.494,.511,380,450,.844,52,309,361,484,102,34,211,131,2102
2019,Lonnie Walker IV,SG,20,SAS,17,0,118,16,46,.348,5,13,.385,11,33,.333,.402,8,10,.800,0,17,17,9,7,3,4,7,45
2019,John Wall,PG,28,WAS,32,32,1104,245,552,.444,51,169,.302,194,383,.507,.490,122,175,.697,15,101,116,279,49,29,121,71,663
2019,Tyrone Wallace,PG,24,LAC,62,0,628,92,217,.424,4,19,.211,88,198,.444,.433,30,57,.526,20,81,101,42,21,7,36,83,218
2019,Brad Wanamaker,PG,29,BOS,36,0,343,50,105,.476,16,39,.410,34,66,.515,.552,24,28,.857,3,38,41,56,12,2,19,34,140
2019,T.J. Warren,SF,25,PHO,43,36,1360,297,611,.486,77,180,.428,220,431,.510,.549,101,124,.815,31,143,174,64,51,29,52,119,772
2019,Julian Washburn,SF,27,MEM,18,3,254,16,48,.333,5,24,.208,11,24,.458,.385,3,4,.750,8,33,41,14,13,2,7,16,40
2019,Yuta Watanabe,SF,24,MEM,15,0,174,15,51,.294,2,16,.125,13,35,.371,.314,7,10,.700,4,27,31,8,4,1,6,11,39
2019,Thomas Welsh,C,22,DEN,11,0,36,7,13,.538,3,7,.429,4,6,.667,.654,1,2,.500,0,4,4,5,0,0,1,3,18
2019,Russell Westbrook,PG,30,OKC,73,73,2630,630,1473,.428,119,411,.290,511,1062,.481,.468,296,451,.656,109,698,807,784,142,33,325,245,1675
2019,Derrick White,PG,24,SAS,67,55,1728,260,543,.479,48,142,.338,212,401,.529,.523,95,123,.772,35,212,247,263,67,47,97,145,663
2019,Okaro White,PF,26,WAS,3,0,6,0,2,.000,0,2,.000,0,0,,.000,0,0,,1,1,2,0,0,0,0,0,0
2019,Hassan Whiteside,C,29,MIA,72,53,1674,388,680,.571,2,16,.125,386,664,.581,.572,109,243,.449,257,560,817,56,46,136,97,192,887
2019,Andrew Wiggins,SF,23,MIN,73,73,2543,498,1209,.412,118,348,.339,380,861,.441,.461,207,296,.699,83,269,352,184,70,48,138,153,1321
2019,Alan Williams,PF,26,BRK,5,0,26,8,13,.615,0,1,.000,8,12,.667,.615,2,4,.500,4,15,19,3,1,0,1,2,18
2019,C.J. Williams,SG,28,MIN,15,0,128,17,35,.486,5,16,.313,12,19,.632,.557,0,1,.000,1,7,8,12,6,0,5,16,39
2019,Johnathan Williams,C,23,LAL,24,0,372,65,110,.591,0,2,.000,65,108,.602,.591,27,48,.563,48,51,99,13,8,7,16,62,157
2019,Kenrich Williams,SF,24,NOP,46,29,1079,107,279,.384,52,156,.333,55,123,.447,.477,13,19,.684,55,164,219,83,45,19,36,95,279
2019,Lou Williams,SG,32,LAC,75,1,1993,484,1138,.425,105,291,.361,379,847,.447,.471,425,485,.876,40,182,222,402,57,11,181,80,1498
2019,Marvin Williams,PF,32,CHO,75,75,2133,275,652,.422,140,382,.366,135,270,.500,.529,66,86,.767,76,331,407,92,71,61,47,156,756
2019,Robert Williams,C,21,BOS,32,2,283,36,51,.706,0,0,,36,51,.706,.706,9,15,.600,27,54,81,7,9,40,10,36,81
2019,Troy Williams,SF,24,SAC,21,0,312,44,98,.449,14,44,.318,30,54,.556,.520,9,15,.600,12,47,59,11,10,8,9,37,111
2019,D.J. Wilson,PF,22,MIL,48,3,882,104,251,.414,46,127,.362,58,124,.468,.506,26,47,.553,45,177,222,52,18,20,32,85,280
2019,Justise Winslow,SF,22,MIA,66,52,1959,324,749,.433,96,256,.375,228,493,.462,.497,86,137,.628,63,292,355,282,72,19,142,177,830
2019,Christian Wood,PF,23,TOT,21,2,251,61,117,.521,9,26,.346,52,91,.571,.560,41,56,.732,17,66,83,8,7,10,17,17,172
2019,Delon Wright,PG,26,TOT,75,13,1699,242,558,.434,50,168,.298,192,390,.492,.478,119,150,.793,68,198,266,248,88,30,77,103,653
2019,Guerschon Yabusele,PF,23,BOS,41,1,251,35,77,.455,9,28,.321,26,49,.531,.513,15,22,.682,23,30,53,15,8,7,15,32,94
2019,Nick Young,SG,33,DEN,4,0,37,3,9,.333,3,8,.375,0,1,.000,.500,0,0,,0,1,1,2,0,1,2,4,9
2019,Thaddeus Young,PF,30,IND,81,81,2489,443,841,.527,51,146,.349,392,695,.564,.557,87,135,.644,192,331,523,204,123,36,123,194,1024
2019,Trae Young,PG,20,ATL,81,81,2503,525,1256,.418,156,482,.324,369,774,.477,.480,343,414,.829,64,237,301,653,72,15,308,140,1549
2019,Cody Zeller,C,26,CHO,49,47,1243,190,345,.551,6,22,.273,184,323,.570,.559,111,141,.787,110,223,333,102,38,41,62,164,497
2019,Tyler Zeller,C,29,TOT,6,1,93,16,30,.533,0,1,.000,16,29,.552,.533,14,18,.778,11,13,24,4,1,3,4,20,46
2019,Ante Žižić,C,22,CLE,59,25,1082,183,331,.553,0,0,,183,331,.553,.553,93,132,.705,108,212,320,53,13,22,61,113,459
2019,Ivica Zubac,C,21,TOT,59,37,1040,212,379,.559,0,0,,212,379,.559,.559,101,126,.802,115,247,362,63,14,51,70,137,525
2020,Steven Adams,C,26,OKC,63,63,1680,283,478,.592,1,3,.333,282,475,.594,.593,117,201,.582,207,376,583,146,51,67,94,122,684
2020,Bam Adebayo,PF,22,MIA,72,72,2417,440,790,.557,2,14,.143,438,776,.564,.558,264,382,.691,176,559,735,368,82,93,204,182,1146
2020,LaMarcus Aldridge,C,34,SAS,53,53,1754,391,793,.493,61,157,.389,330,636,.519,.532,158,191,.827,103,289,392,129,36,87,74,128,1001
2020,Kyle Alexander,C,23,MIA,2,0,13,1,2,.500,0,0,,1,2,.500,.500,0,0,,2,1,3,0,0,0,1,1,2
2020,Nickeil Alexander-Walker,SG,21,NOP,47,1,591,98,266,.368,46,133,.346,52,133,.391,.455,25,37,.676,9,75,84,89,17,8,54,57,267
2020,Grayson Allen,SG,24,MEM,38,0,718,117,251,.466,57,141,.404,60,110,.545,.580,39,45,.867,8,77,85,52,10,2,33,53,330
2020,Jarrett Allen,C,21,BRK,70,64,1852,302,465,.649,0,6,.000,302,459,.658,.649,171,270,.633,216,455,671,110,40,92,77,162,775
2020,Kadeem Allen,PG,27,NYK,10,0,117,19,44,.432,5,16,.313,14,28,.500,.489,7,11,.636,2,7,9,21,5,2,8,7,50
2020,Al-Farouq Aminu,PF,29,ORL,18,2,380,25,86,.291,9,36,.250,16,50,.320,.343,19,29,.655,24,63,87,21,18,8,17,27,78
2020,Justin Anderson,SG,26,BRK,10,1,107,10,38,.263,6,29,.207,4,9,.444,.342,2,4,.500,1,20,21,8,0,6,4,13,28
2020,Kyle Anderson,SF,26,MEM,67,28,1330,157,331,.474,24,85,.282,133,246,.541,.511,52,78,.667,58,227,285,162,54,37,66,111,390
2020,Ryan Anderson,C,31,HOU,2,0,14,2,7,.286,1,5,.200,1,2,.500,.357,0,0,,0,7,7,2,1,0,1,1,5
2020,Giannis Antetokounmpo,PF,25,MIL,63,63,1917,685,1238,.553,89,293,.304,596,945,.631,.589,398,629,.633,140,716,856,354,61,66,230,195,1857
2020,Kostas Antetokounmpo,PF,22,LAL,5,0,20,3,3,1.000,0,0,,3,3,1.000,1.000,1,2,.500,2,1,3,2,0,0,1,2,7
2020,Thanasis Antetokounmpo,SF,27,MIL,20,2,129,24,48,.500,0,10,.000,24,38,.632,.500,7,17,.412,12,12,24,15,7,2,12,18,55
2020,Carmelo Anthony,PF,35,POR,58,58,1902,336,782,.430,87,226,.385,249,556,.448,.485,136,161,.845,71,297,368,85,49,27,100,171,895
2020,OG Anunoby,SF,22,TOR,69,68,2066,286,566,.505,89,228,.390,197,338,.583,.584,72,102,.706,80,284,364,108,96,45,79,167,733
2020,Ryan Arcidiacono,PG,25,CHI,58,4,930,90,220,.409,54,138,.391,36,82,.439,.532,27,38,.711,20,90,110,96,27,3,37,96,261
2020,Trevor Ariza,SF,34,TOT,53,21,1493,142,324,.438,77,207,.372,65,117,.556,.557,62,74,.838,34,212,246,91,69,15,56,111,423
2020,D.J. Augustin,PG,32,ORL,57,13,1420,184,461,.399,70,201,.348,114,260,.438,.475,161,181,.890,22,100,122,262,34,1,86,72,599
2020,Deandre Ayton,C,21,PHO,38,32,1236,310,568,.546,3,13,.231,307,555,.553,.548,67,89,.753,147,289,436,72,26,58,80,117,690
2020,Dwayne Bacon,SG,24,CHO,39,11,687,85,244,.348,19,67,.284,66,177,.373,.387,35,53,.660,15,85,100,52,23,2,37,52,224
2020,Marvin Bagley III,C,20,SAC,13,6,334,78,167,.467,4,22,.182,74,145,.510,.479,25,31,.806,29,68,97,10,6,12,18,43,185
2020,Lonzo Ball,PG,22,NOP,63,54,2025,277,687,.403,148,395,.375,129,292,.442,.511,43,76,.566,71,312,383,438,88,38,193,128,745
2020,Mo Bamba,C,21,ORL,62,0,878,132,286,.462,37,107,.346,95,179,.531,.526,31,46,.674,100,202,302,42,23,86,42,116,332
2020,J.J. Barea,PG,35,DAL,29,6,450,85,207,.411,32,85,.376,53,122,.434,.488,20,22,.909,10,43,53,112,5,2,38,27,222
2020,Harrison Barnes,PF,27,SAC,72,72,2482,365,793,.460,102,268,.381,263,525,.501,.525,214,267,.801,77,278,355,159,43,12,88,93,1046
2020,RJ Barrett,SG,19,NYK,56,55,1704,292,727,.402,63,197,.320,229,530,.432,.445,156,254,.614,50,229,279,143,55,17,124,122,803
2020,Will Barton,SF,29,DEN,58,58,1916,332,738,.450,108,288,.375,224,450,.498,.523,102,133,.767,76,289,365,212,61,29,88,121,874
2020,Keita Bates-Diop,PF-SF,24,TOT,44,0,744,100,234,.427,34,103,.330,66,131,.504,.500,54,75,.720,25,102,127,30,19,24,17,43,288
2020,Nicolas Batum,SF,31,CHO,22,3,505,28,81,.346,14,49,.286,14,32,.438,.432,9,10,.900,25,75,100,66,17,8,22,41,79
2020,Aron Baynes,C,33,PHO,42,28,934,183,381,.480,59,168,.351,124,213,.582,.558,56,75,.747,71,166,237,67,10,23,50,141,481
2020,Kent Bazemore,SF,30,TOT,68,21,1688,200,534,.375,84,244,.344,116,290,.400,.453,113,147,.769,27,267,294,93,74,40,91,196,597
2020,Darius Bazley,PF,19,OKC,61,9,1130,125,317,.394,49,141,.348,76,176,.432,.472,43,62,.694,30,216,246,41,23,41,45,55,342
2020,Bradley Beal,SG,26,WAS,57,57,2053,593,1303,.455,170,481,.353,423,822,.515,.520,385,457,.842,52,190,242,347,71,23,194,126,1741
2020,Malik Beasley,SG,23,TOT,55,14,1209,227,534,.425,107,276,.388,120,258,.465,.525,54,66,.818,18,130,148,75,40,8,57,77,615
2020,Marco Belinelli,SG,33,SAS,57,0,883,123,314,.392,67,178,.376,56,136,.412,.498,48,58,.828,7,92,99,69,12,1,19,45,361
2020,Jordan Bell,C,25,TOT,29,0,256,35,67,.522,4,12,.333,31,55,.564,.552,19,31,.613,30,51,81,16,3,10,21,19,93
2020,DeAndre' Bembry,SG,25,ATL,43,4,915,104,228,.456,15,65,.231,89,163,.546,.489,26,48,.542,34,118,152,81,55,19,60,84,249
2020,Dragan Bender,PF-C,22,TOT,16,3,286,41,92,.446,15,43,.349,26,49,.531,.527,10,14,.714,16,57,73,28,4,9,21,42,107
2020,Dāvis Bertāns,PF,27,WAS,54,4,1583,265,610,.434,200,472,.424,65,138,.471,.598,104,122,.852,35,210,245,92,37,33,59,139,834
2020,Patrick Beverley,PG,31,LAC,51,50,1342,147,341,.431,80,206,.388,67,135,.496,.548,31,47,.660,57,209,266,183,54,25,66,156,405
2020,Khem Birch,C,27,ORL,48,24,922,73,143,.510,0,1,.000,73,142,.514,.510,66,101,.653,91,129,220,50,20,23,31,91,212
2020,Goga Bitadze,C,20,IND,54,2,471,70,150,.467,8,42,.190,62,108,.574,.493,24,33,.727,25,81,106,23,10,37,28,65,172
2020,Bismack Biyombo,C,27,CHO,53,29,1029,151,278,.543,0,0,,151,278,.543,.543,91,151,.603,120,188,308,50,10,49,48,116,393
2020,Nemanja Bjelica,PF,31,SAC,72,67,2011,314,653,.481,134,320,.419,180,333,.541,.583,69,84,.821,111,347,458,203,62,40,99,216,831
2020,Eric Bledsoe,PG,30,MIL,61,61,1646,334,703,.475,74,215,.344,260,488,.533,.528,169,214,.790,43,239,282,328,57,26,148,128,911
2020,Bogdan Bogdanović,SG,27,SAC,61,28,1766,337,766,.440,164,441,.372,173,325,.532,.547,86,116,.741,26,181,207,207,64,15,102,133,924
2020,Bojan Bogdanović,SF,30,UTA,63,63,2083,418,935,.447,189,457,.414,229,478,.479,.548,250,277,.903,39,220,259,131,34,7,159,110,1275
2020,Bol Bol,PF,20,DEN,7,0,87,14,28,.500,4,9,.444,10,19,.526,.571,8,10,.800,5,14,19,6,2,6,10,11,40
2020,Jonah Bolden,C,24,TOT,7,0,47,4,11,.364,0,4,.000,4,7,.571,.364,2,4,.500,3,6,9,0,3,2,2,10,10
2020,Marques Bolden,C,21,CLE,1,0,3,0,0,,0,0,,0,0,,,0,0,,0,2,2,0,1,0,0,1,0
2020,Jordan Bone,PG,22,DET,10,0,53,5,20,.250,2,10,.200,3,10,.300,.300,0,0,,0,4,4,8,1,0,2,6,12
2020,Isaac Bonga,SF,20,WAS,66,49,1250,118,234,.504,25,71,.352,93,163,.571,.558,69,85,.812,71,151,222,76,45,22,58,156,330
2020,Devin Booker,SG,23,PHO,70,70,2512,627,1283,.489,141,398,.354,486,885,.549,.544,468,509,.919,29,268,297,456,49,18,264,213,1863
2020,Chris Boucher,C,27,TOR,62,0,819,141,299,.472,38,118,.322,103,181,.569,.535,91,116,.784,107,170,277,26,22,61,28,114,411
2020,Brian Bowen,SF,21,IND,6,1,31,3,10,.300,0,2,.000,3,8,.375,.300,0,0,,1,6,7,0,0,1,1,3,6
2020,Ky Bowman,PG,22,GSW,45,12,1015,134,321,.417,33,107,.308,101,214,.472,.469,34,41,.829,24,97,121,131,44,10,70,102,335
2020,Avery Bradley,SG,29,LAL,49,44,1186,170,383,.444,63,173,.364,107,210,.510,.526,20,24,.833,18,97,115,63,43,5,47,110,423
2020,Tony Bradley,C,22,UTA,58,3,663,126,189,.667,3,3,1.000,123,186,.661,.675,30,46,.652,111,156,267,23,14,33,30,115,285
2020,Jarrell Brantley,PF,23,UTA,9,0,96,10,28,.357,3,13,.231,7,15,.467,.411,1,2,.500,2,18,20,11,3,5,7,7,24
2020,Ignas Brazdeikis,SF,21,NYK,9,0,53,6,22,.273,1,9,.111,5,13,.385,.295,4,5,.800,2,3,5,4,0,1,2,3,17
2020,Corey Brewer,PF,33,SAC,5,0,33,2,4,.500,0,1,.000,2,3,.667,.500,1,3,.333,2,6,8,2,4,0,2,7,5
2020,Mikal Bridges,SF,23,PHO,73,32,2042,247,484,.510,70,194,.361,177,290,.610,.583,103,122,.844,66,226,292,129,102,46,73,163,667
2020,Miles Bridges,SF,21,CHO,65,64,1995,319,753,.424,99,300,.330,220,453,.486,.489,106,131,.809,88,274,362,114,40,48,95,132,843
2020,Oshae Brissett,SF,21,TOR,19,0,135,13,36,.361,3,15,.200,10,21,.476,.403,8,10,.800,9,17,26,7,4,1,7,18,37
2020,Ryan Broekhoff,SF,29,DAL,17,1,180,22,59,.373,20,51,.392,2,8,.250,.542,7,8,.875,5,38,43,11,5,4,6,15,71
2020,Malcolm Brogdon,PG,27,IND,54,54,1666,326,744,.438,75,230,.326,251,514,.488,.489,166,186,.892,46,216,262,381,35,10,131,98,893
2020,Dillon Brooks,SG,24,MEM,73,73,2112,435,1068,.407,147,411,.358,288,657,.438,.476,164,203,.808,68,175,243,150,63,27,124,278,1181
2020,Bruce Brown,PG,23,DET,58,43,1634,198,447,.443,33,96,.344,165,351,.470,.480,88,119,.739,61,213,274,230,63,29,100,162,517
2020,Charlie Brown Jr.,SG,22,ATL,10,0,40,6,19,.316,3,9,.333,3,10,.300,.395,5,5,1.000,2,2,4,2,2,2,3,3,20
2020,Jaylen Brown,SG,23,BOS,57,57,1934,427,887,.481,129,338,.382,298,549,.543,.554,176,243,.724,62,302,364,118,65,20,125,167,1159
2020,Moses Brown,C,20,POR,9,0,33,4,10,.400,0,0,,4,10,.400,.400,3,8,.375,3,11,14,1,1,1,3,7,11
2020,Sterling Brown,SF,24,MIL,52,1,767,95,256,.371,44,136,.324,51,120,.425,.457,32,40,.800,31,152,183,51,29,7,42,54,266
2020,Troy Brown Jr.,SF,20,WAS,69,22,1782,273,622,.439,61,179,.341,212,443,.479,.488,109,139,.784,76,307,383,178,85,7,79,132,716
2020,Jalen Brunson,PG,23,DAL,57,16,1022,181,388,.466,43,120,.358,138,268,.515,.522,61,75,.813,22,112,134,188,22,4,66,74,466
2020,Thomas Bryant,C,22,WAS,46,36,1147,243,418,.581,37,91,.407,206,327,.630,.626,86,116,.741,98,233,331,83,25,49,53,103,609
2020,Reggie Bullock,SG,28,NYK,29,19,684,90,224,.402,37,111,.333,53,113,.469,.484,17,21,.810,13,55,68,42,25,3,19,56,234
2020,Trey Burke,PG,27,TOT,33,1,520,94,209,.450,32,75,.427,62,134,.463,.526,23,29,.793,16,34,50,83,16,2,21,33,243
2020,Alec Burks,SF-SG,28,TOT,66,19,1754,321,768,.418,116,301,.385,205,467,.439,.493,235,265,.887,48,234,282,189,62,17,91,128,993
2020,Deonte Burton,SF,26,OKC,39,0,356,43,125,.344,10,53,.189,33,72,.458,.384,8,14,.571,7,50,57,17,7,10,19,34,104
2020,Jimmy Butler,SF,30,MIA,58,58,1959,345,758,.455,29,119,.244,316,639,.495,.474,438,525,.834,106,280,386,350,103,32,127,81,1157
2020,Bruno Caboclo,C,24,TOT,30,0,244,38,89,.427,6,33,.182,32,56,.571,.461,8,9,.889,23,37,60,12,15,17,13,31,90
2020,Devontae Cacok,C,23,LAL,1,0,9,3,6,.500,0,0,,3,6,.500,.500,0,0,,2,3,5,1,0,0,0,0,6
2020,Kentavious Caldwell-Pope,SG,26,LAL,69,26,1762,237,507,.467,92,239,.385,145,268,.541,.558,79,102,.775,38,104,142,111,57,14,62,128,645
2020,Vlatko Čančar,PF,22,DEN,14,0,45,6,15,.400,1,6,.167,5,9,.556,.433,4,4,1.000,5,5,10,3,1,1,3,7,17
2020,Clint Capela,C,25,HOU,39,39,1279,244,388,.629,0,0,,244,388,.629,.629,55,104,.529,168,369,537,48,33,72,63,102,543
2020,DeMarre Carroll,SF-C,33,TOT,24,0,290,25,66,.379,8,33,.242,17,33,.515,.439,29,42,.690,12,43,55,25,8,5,17,32,87
2020,Jevon Carter,PG,24,PHO,58,2,945,101,243,.416,62,146,.425,39,97,.402,.543,23,27,.852,30,88,118,84,47,17,32,86,287
2020,Vince Carter,PF,43,ATL,60,0,876,107,304,.352,61,202,.302,46,102,.451,.452,23,29,.793,18,106,124,48,23,25,33,90,298
2020,Wendell Carter Jr.,C,20,CHI,43,43,1256,183,343,.534,6,29,.207,177,314,.564,.542,112,152,.737,139,266,405,51,33,36,72,162,484
2020,Michael Carter-Williams,SG,28,ORL,45,0,833,111,260,.427,22,75,.293,89,185,.481,.469,79,95,.832,46,101,147,109,49,22,52,87,323
2020,Alex Caruso,PG,25,LAL,64,2,1175,120,291,.412,40,120,.333,80,171,.468,.481,69,94,.734,17,106,123,124,70,18,53,98,349
2020,Willie Cauley-Stein,C,26,TOT,54,39,1097,175,302,.579,0,1,.000,175,301,.581,.579,40,66,.606,84,231,315,70,49,61,40,121,390
2020,Tyson Chandler,C,37,HOU,26,5,219,14,18,.778,0,0,,14,18,.778,.778,6,13,.462,25,41,66,6,6,8,8,32,34
2020,Wilson Chandler,PF,32,BRK,35,3,734,74,183,.404,37,121,.306,37,62,.597,.505,20,23,.870,11,134,145,39,16,12,34,79,205
2020,Joe Chealey,PG,24,CHO,4,0,33,0,7,.000,0,4,.000,0,3,.000,.000,2,2,1.000,0,0,0,1,4,0,2,2,2
2020,Zylan Cheatham,PF,24,NOP,4,0,51,6,9,.667,0,1,.000,6,8,.750,.667,0,0,,3,6,9,3,1,1,4,10,12
2020,Chris Chiozza,PG,24,TOT,28,2,401,55,140,.393,27,72,.375,28,68,.412,.489,5,5,1.000,9,44,53,83,21,4,32,37,142
2020,Marquese Chriss,PF,22,GSW,59,21,1196,210,385,.545,8,39,.205,202,346,.584,.556,120,156,.769,114,251,365,114,39,62,78,122,548
2020,Gary Clark,SF-PF,25,TOT,42,5,567,54,133,.406,39,111,.351,15,22,.682,.553,9,10,.900,37,73,110,17,6,22,10,46,156
2020,Brandon Clarke,PF,23,MEM,58,4,1300,296,479,.618,23,64,.359,273,415,.658,.642,85,112,.759,92,253,345,81,32,48,55,100,700
2020,Jordan Clarkson,SG,27,TOT,71,2,1705,394,867,.454,152,413,.368,242,454,.533,.542,138,165,.836,50,137,187,136,46,16,97,108,1078
2020,Nic Claxton,C,20,BRK,15,0,187,27,48,.563,1,7,.143,26,41,.634,.573,11,21,.524,19,25,44,16,1,8,9,14,66
2020,Chris Clemons,SG,22,HOU,33,0,291,57,142,.401,37,107,.346,20,35,.571,.532,10,11,.909,4,26,30,27,9,6,19,26,161
2020,Antonius Cleveland,SG,25,DAL,11,0,46,4,14,.286,0,3,.000,4,11,.364,.286,3,5,.600,2,5,7,1,1,3,2,8,11
2020,Amir Coffey,SG,22,LAC,18,1,159,23,54,.426,6,19,.316,17,35,.486,.481,6,11,.545,4,12,16,14,5,2,8,20,58
2020,John Collins,PF,22,ATL,41,41,1363,353,605,.583,59,147,.401,294,458,.642,.632,120,150,.800,116,300,416,60,31,66,75,138,885
2020,Zach Collins,PF,22,POR,11,11,290,32,68,.471,7,19,.368,25,49,.510,.522,6,8,.750,25,44,69,16,5,5,14,36,77
2020,Mike Conley,PG,32,UTA,47,41,1363,232,567,.409,96,256,.375,136,311,.437,.494,115,139,.827,33,118,151,208,36,5,92,104,675
2020,Pat Connaughton,SG,27,MIL,67,4,1243,137,301,.455,55,166,.331,82,135,.607,.547,31,40,.775,60,224,284,107,25,31,52,70,360
2020,Quinn Cook,PG,26,LAL,44,1,508,91,214,.425,31,85,.365,60,129,.465,.498,11,14,.786,11,40,51,49,12,2,33,27,224
2020,Tyler Cook,PF-SF,22,TOT,13,0,54,8,12,.667,0,0,,8,12,.667,.667,7,8,.875,6,8,14,1,3,0,3,5,23
2020,Robert Covington,PF-C,29,TOT,70,68,2137,305,723,.422,161,480,.335,144,243,.593,.533,99,124,.798,63,400,463,88,115,93,103,220,870
2020,Allen Crabbe,SG-SF,27,TOT,37,1,653,63,177,.356,36,119,.303,27,58,.466,.458,10,14,.714,11,66,77,33,15,4,17,47,172
2020,Torrey Craig,SF,29,DEN,58,27,1072,124,269,.461,45,138,.326,79,131,.603,.545,22,36,.611,63,126,189,47,23,36,25,135,315
2020,Jamal Crawford,SG,39,BRK,1,0,6,2,4,.500,1,2,.500,1,2,.500,.625,0,0,,0,0,0,3,0,0,0,1,5
2020,Jae Crowder,SF-PF,29,TOT,65,53,1875,226,563,.401,135,394,.343,91,169,.538,.521,97,125,.776,52,332,384,161,72,24,69,143,684
2020,Jarrett Culver,SG,20,MIN,63,35,1506,230,569,.404,66,221,.299,164,348,.471,.462,54,117,.462,70,142,212,110,57,38,81,125,580
2020,Seth Curry,SG,29,DAL,64,25,1576,284,574,.495,145,321,.452,139,253,.549,.621,80,97,.825,27,118,145,124,38,9,62,113,793
2020,Stephen Curry,PG,31,GSW,5,5,139,33,82,.402,12,49,.245,21,33,.636,.476,26,26,1.000,4,22,26,33,5,2,16,11,104
2020,Troy Daniels,SG,28,TOT,47,0,532,72,186,.387,46,132,.348,26,54,.481,.511,10,16,.625,12,40,52,17,11,3,12,37,200
2020,Anthony Davis,PF,26,LAL,62,62,2131,551,1096,.503,72,218,.330,479,878,.546,.536,444,525,.846,142,435,577,200,91,143,154,156,1618
2020,Ed Davis,C,30,UTA,28,1,303,22,46,.478,0,0,,22,46,.478,.478,7,14,.500,35,70,105,12,11,9,13,61,51
2020,Terence Davis,SG,22,TOR,72,4,1209,199,436,.456,94,242,.388,105,194,.541,.564,51,59,.864,50,187,237,115,39,14,76,124,543
2020,Dewayne Dedmon,C,30,TOT,44,18,774,102,255,.400,22,107,.206,80,148,.541,.443,30,36,.833,60,189,249,22,25,41,57,133,256
2020,Matthew Dellavedova,PG,29,CLE,57,4,821,62,175,.354,21,91,.231,41,84,.488,.414,32,37,.865,18,57,75,180,20,2,59,78,177
2020,DeMar DeRozan,SF,30,SAS,68,68,2316,557,1049,.531,9,35,.257,548,1014,.540,.535,381,451,.845,44,331,375,380,70,20,164,180,1504
2020,Cheick Diallo,C,23,PHO,47,2,479,92,142,.648,1,3,.333,91,139,.655,.651,34,39,.872,30,101,131,22,11,12,32,55,219
2020,Hamidou Diallo,SF,21,OKC,46,3,896,132,296,.446,16,57,.281,116,239,.485,.473,38,63,.603,44,123,167,36,37,9,51,101,318
2020,Gorgui Dieng,C,30,TOT,63,17,1096,166,364,.456,54,152,.355,112,212,.528,.530,78,101,.772,91,263,354,73,51,59,60,124,464
2020,Spencer Dinwiddie,PG,26,BRK,64,49,1994,424,1021,.415,123,400,.308,301,621,.485,.476,347,446,.778,32,189,221,432,40,21,174,180,1318
2020,Donte DiVincenzo,SG,23,MIL,66,24,1520,232,510,.455,83,247,.336,149,263,.567,.536,63,86,.733,66,252,318,154,85,20,90,113,610
2020,Luka Dončić,PG,20,DAL,61,61,2047,581,1255,.463,171,541,.316,410,714,.574,.531,426,562,.758,78,495,573,538,62,14,260,153,1759
2020,Luguentz Dort,SF,20,OKC,36,28,820,86,218,.394,30,101,.297,56,117,.479,.463,42,53,.792,24,57,81,27,31,4,22,97,244
2020,Damyean Dotson,SG,25,NYK,48,0,836,120,290,.414,59,163,.362,61,127,.480,.516,22,33,.667,10,81,91,57,23,4,21,44,321
2020,Sekou Doumbouya,PF,19,DET,38,19,754,92,236,.390,28,98,.286,64,138,.464,.449,31,46,.674,20,98,118,19,20,8,35,80,243
2020,PJ Dozier,SG,23,DEN,29,0,412,65,157,.414,17,49,.347,48,108,.444,.468,21,29,.724,10,45,55,63,14,6,27,45,168
2020,Goran Dragić,PG,33,MIA,59,3,1663,319,724,.441,124,338,.367,195,386,.505,.526,191,246,.776,29,158,187,301,40,10,144,124,953
2020,Andre Drummond,C,26,TOT,57,56,1879,418,784,.533,5,35,.143,413,749,.551,.536,169,294,.575,250,614,864,152,109,93,203,201,1010
2020,Jared Dudley,PF,34,LAL,45,1,364,24,60,.400,18,42,.429,6,18,.333,.550,2,2,1.000,6,46,52,28,15,3,8,41,68
2020,Kris Dunn,PG,25,CHI,51,32,1269,152,342,.444,29,112,.259,123,230,.535,.487,40,54,.741,23,163,186,173,101,17,68,158,373
2020,Carsen Edwards,SG,21,BOS,37,0,351,42,128,.328,24,76,.316,18,52,.346,.422,13,19,.684,6,41,47,24,12,4,15,34,121
2020,Henry Ellenson,C,23,BRK,5,0,15,1,7,.143,0,4,.000,1,3,.333,.143,0,0,,2,4,6,1,0,0,0,1,2
2020,Wayne Ellington,SG,32,NYK,36,1,558,61,174,.351,50,143,.350,11,31,.355,.494,11,13,.846,4,61,65,44,13,4,18,41,183
2020,Joel Embiid,C,25,PHI,51,51,1506,382,801,.477,57,172,.331,325,629,.517,.512,351,435,.807,141,452,593,152,45,65,159,174,1172
2020,James Ennis III,SF-SG,29,TOT,69,18,1265,160,359,.446,55,169,.325,105,190,.553,.522,79,98,.806,71,174,245,63,35,22,58,137,454
2020,Drew Eubanks,C,22,SAS,22,3,272,43,67,.642,1,1,1.000,42,66,.636,.649,20,26,.769,28,57,85,15,5,17,21,37,107
2020,Jacob Evans,SG,22,TOT,29,1,418,45,134,.336,13,39,.333,32,95,.337,.384,25,29,.862,9,32,41,31,11,12,25,41,128
2020,Dante Exum,SG,24,TOT,35,1,485,56,119,.471,15,43,.349,41,76,.539,.534,32,43,.744,12,55,67,40,13,8,31,38,159
2020,Tacko Fall,C,24,BOS,7,0,33,11,14,.786,0,0,,11,14,.786,.786,1,3,.333,1,14,15,1,1,4,3,7,23
2020,Derrick Favors,C,28,NOP,51,49,1243,209,339,.617,1,7,.143,208,332,.627,.618,40,71,.563,163,338,501,81,30,46,55,107,459
2020,Cristiano Felício,C,27,CHI,22,0,386,34,54,.630,0,2,.000,34,52,.654,.630,18,23,.783,55,47,102,16,10,2,18,34,86
2020,Terrance Ferguson,SF,21,OKC,56,38,1257,78,220,.355,49,168,.292,29,52,.558,.466,15,20,.750,23,51,74,51,27,17,31,155,220
2020,Bruno Fernando,C,21,ATL,56,13,713,103,199,.518,5,37,.135,98,162,.605,.530,29,51,.569,67,131,198,49,18,17,42,107,240
2020,Yogi Ferrell,PG,26,SAC,50,0,530,79,188,.420,24,79,.304,55,109,.505,.484,36,42,.857,6,43,49,69,18,4,28,38,218
2020,Dorian Finney-Smith,PF,26,DAL,71,68,2120,243,522,.466,114,303,.376,129,219,.589,.575,78,108,.722,145,260,405,114,45,39,69,178,678
2020,Bryn Forbes,SG,26,SAS,63,62,1579,242,581,.417,148,381,.388,94,200,.470,.544,75,90,.833,12,114,126,108,33,0,57,113,707
2020,Evan Fournier,SF,27,ORL,66,66,2076,434,929,.467,173,434,.399,261,495,.527,.560,180,220,.818,18,153,171,209,71,15,125,161,1221
2020,De'Aaron Fox,PG,22,SAC,51,49,1634,391,815,.480,54,185,.292,337,630,.535,.513,241,342,.705,35,161,196,348,74,25,158,145,1077
2020,Melvin Frazier,SG,23,ORL,19,0,126,15,34,.441,8,16,.500,7,18,.389,.559,2,4,.500,2,8,10,3,9,2,5,11,40
2020,Michael Frazier,SG,25,HOU,13,0,145,7,29,.241,4,23,.174,3,6,.500,.310,9,14,.643,1,9,10,2,2,0,5,22,27
2020,Tim Frazier,PG,29,DET,27,11,355,34,94,.362,10,30,.333,24,64,.375,.415,19,24,.792,9,24,33,93,14,4,36,42,97
2020,Enes Freedom,C,27,BOS,58,7,983,199,348,.572,1,7,.143,198,341,.581,.573,70,99,.707,163,268,431,56,22,41,56,100,469
2020,Markelle Fultz,PG,21,ORL,72,60,1996,359,772,.465,36,135,.267,323,637,.507,.488,116,159,.730,41,197,238,369,90,11,147,142,870
2020,Wenyen Gabriel,PF,22,TOT,30,1,235,21,48,.438,6,20,.300,15,28,.536,.500,15,22,.682,21,31,52,8,11,7,16,39,63
2020,Daniel Gafford,C,21,CHI,43,7,609,94,134,.701,0,0,,94,134,.701,.701,32,60,.533,52,54,106,21,13,56,29,98,220
2020,Danilo Gallinari,PF,31,OKC,62,62,1834,358,817,.438,178,439,.405,180,378,.476,.547,266,298,.893,34,288,322,119,42,5,76,75,1160
2020,Langston Galloway,SG,28,DET,66,6,1702,236,542,.435,132,331,.399,104,211,.493,.557,73,85,.859,33,116,149,101,48,11,40,96,677
2020,Darius Garland,SG,20,CLE,59,59,1824,280,699,.401,105,296,.355,175,403,.434,.476,63,72,.875,27,84,111,229,42,4,151,92,728
2020,Marc Gasol,C,35,TOR,44,43,1161,119,279,.427,57,148,.385,62,131,.473,.529,36,49,.735,31,244,275,147,34,38,59,124,331
2020,Rudy Gay,PF,33,SAS,67,5,1461,266,596,.446,74,220,.336,192,376,.511,.508,120,136,.882,61,301,362,114,35,33,88,103,726
2020,Paul George,SF,29,LAC,48,48,1419,343,782,.439,157,381,.412,186,401,.464,.539,190,217,.876,24,248,272,185,68,20,125,113,1033
2020,Taj Gibson,C,34,NYK,62,56,1025,167,286,.584,4,14,.286,163,272,.599,.591,41,56,.732,111,156,267,52,27,30,47,122,379
2020,Harry Giles,C,21,SAC,46,17,667,139,251,.554,0,2,.000,139,249,.558,.554,38,49,.776,43,145,188,60,22,18,44,119,316
2020,Shai Gilgeous-Alexander,SG,21,OKC,70,70,2428,478,1015,.471,87,251,.347,391,764,.512,.514,288,357,.807,47,365,412,232,79,47,134,117,1331
2020,Rudy Gobert,C,27,UTA,68,68,2333,386,557,.693,0,0,,386,557,.693,.693,254,403,.630,230,686,916,101,51,135,130,215,1026
2020,Brandon Goodwin,PG,24,ATL,34,1,430,76,190,.400,26,87,.299,50,103,.485,.468,28,30,.933,11,61,72,51,12,4,29,43,206
2020,Aaron Gordon,PF,24,ORL,62,62,2017,335,767,.437,73,237,.308,262,530,.494,.484,151,224,.674,107,368,475,228,51,39,100,125,894
2020,Eric Gordon,SF,31,HOU,36,15,1016,171,463,.369,96,303,.317,75,160,.469,.473,82,107,.766,9,62,71,54,23,13,43,70,520
2020,Devonte' Graham,PG,24,CHO,63,53,2211,368,963,.382,218,585,.373,150,378,.397,.495,191,233,.820,42,170,212,471,62,15,181,115,1145
2020,Treveon Graham,SF,26,TOT,55,20,929,87,242,.360,33,120,.275,54,122,.443,.428,36,56,.643,51,99,150,45,24,6,29,102,243
2020,Jerami Grant,PF,25,DEN,71,24,1892,303,634,.478,98,252,.389,205,382,.537,.555,147,196,.750,58,190,248,88,50,57,63,154,851
2020,Jerian Grant,SG,27,WAS,6,0,80,10,27,.370,2,8,.250,8,19,.421,.407,5,7,.714,2,4,6,9,1,1,3,11,27
2020,Josh Gray,PG,26,NOP,2,0,23,1,2,.500,0,0,,1,2,.500,.500,0,0,,1,1,2,2,0,0,5,1,2
2020,Danny Green,SG,32,LAL,68,68,1687,197,474,.416,120,327,.367,77,147,.524,.542,33,48,.688,51,174,225,91,85,32,63,136,547
2020,Draymond Green,PF,29,GSW,43,43,1222,123,316,.389,36,129,.279,87,187,.465,.446,63,83,.759,23,243,266,266,59,33,98,110,345
2020,JaMychal Green,PF,29,LAC,63,1,1307,151,352,.429,92,238,.387,59,114,.518,.560,36,48,.750,77,311,388,49,29,24,54,174,430
2020,Javonte Green,SG,26,BOS,48,2,468,63,126,.500,9,33,.273,54,93,.581,.536,28,42,.667,24,69,93,26,24,8,23,43,163
2020,Jeff Green,PF-C,33,TOT,48,4,960,159,344,.462,62,183,.339,97,161,.602,.552,73,91,.802,24,109,133,50,26,19,42,89,453
2020,Blake Griffin,PF,30,DET,18,18,512,88,250,.352,27,111,.243,61,139,.439,.406,76,98,.776,17,67,84,59,7,7,40,27,279
2020,Marko Guduric,SG,24,MEM,44,0,484,62,157,.395,25,83,.301,37,74,.500,.475,24,26,.923,14,59,73,45,12,8,36,34,173
2020,Kyle Guy,SG,22,SAC,3,0,10,2,5,.400,0,3,.000,2,2,1.000,.400,0,0,,0,1,1,1,0,0,0,1,4
2020,Rui Hachimura,PF,21,WAS,48,48,1444,254,545,.466,25,87,.287,229,458,.500,.489,116,140,.829,78,216,294,87,37,8,53,105,649
2020,Devon Hall,PG,24,OKC,11,0,81,6,30,.200,4,17,.235,2,13,.154,.267,4,8,.500,2,5,7,13,4,1,5,6,20
2020,Donta Hall,C-PF,22,TOT,9,0,133,15,22,.682,0,0,,15,22,.682,.682,9,18,.500,14,24,38,4,3,6,5,23,39
2020,Dusty Hannahs,SG,26,MEM,2,0,13,4,9,.444,2,3,.667,2,6,.333,.556,2,2,1.000,0,1,1,0,0,0,0,1,12
2020,Tim Hardaway Jr.,SG,27,DAL,71,58,2091,384,884,.434,204,513,.398,180,371,.485,.550,149,182,.819,25,207,232,137,41,5,69,125,1121
2020,James Harden,SG,30,HOU,68,68,2483,672,1514,.444,299,843,.355,373,671,.556,.543,692,800,.865,70,376,446,512,125,60,308,227,2335
2020,Maurice Harkless,PF-SF,26,TOT,62,48,1427,142,283,.502,34,98,.347,108,185,.584,.562,39,66,.591,55,185,240,68,58,33,53,148,357
2020,Jared Harper,PG,22,PHO,3,0,8,1,4,.250,0,2,.000,1,2,.500,.250,0,0,,0,0,0,0,0,0,0,0,2
2020,Montrezl Harrell,C,26,LAC,63,2,1749,471,812,.580,0,18,.000,471,794,.593,.580,231,351,.658,163,282,445,107,39,72,108,146,1173
2020,Gary Harris,SG,25,DEN,56,55,1780,218,519,.420,70,210,.333,148,309,.479,.487,75,92,.815,26,137,163,118,76,14,60,116,581
2020,Joe Harris,SF,28,BRK,69,69,2123,381,784,.486,172,406,.424,209,378,.553,.596,64,89,.719,64,234,298,144,41,17,104,159,998
2020,Tobias Harris,PF,27,PHI,72,72,2469,553,1173,.471,131,357,.367,422,816,.517,.527,174,216,.806,69,426,495,227,53,40,104,165,1411
2020,Shaquille Harrison,SG,26,CHI,43,10,484,77,165,.467,16,42,.381,61,123,.496,.515,39,50,.780,22,64,86,49,34,19,19,55,209
2020,Josh Hart,SF,24,NOP,65,16,1755,225,532,.423,121,354,.342,104,178,.584,.537,85,115,.739,61,364,425,108,63,23,75,160,656
2020,Isaiah Hartenstein,C,21,HOU,23,2,266,44,67,.657,0,5,.000,44,62,.710,.657,19,28,.679,29,61,90,18,9,12,16,41,107
2020,Udonis Haslem,C,39,MIA,4,1,44,4,11,.364,1,3,.333,3,8,.375,.409,3,4,.750,1,15,16,1,0,0,1,6,12
2020,Jaxson Hayes,C,19,NOP,64,14,1080,174,259,.672,1,4,.250,173,255,.678,.674,123,190,.647,97,162,259,56,26,55,53,161,472
2020,Gordon Hayward,SF,29,BOS,52,52,1740,350,700,.500,85,222,.383,265,478,.554,.561,124,145,.855,55,293,348,212,38,22,96,96,909
2020,John Henson,C,29,TOT,40,8,600,95,171,.556,8,36,.222,87,135,.644,.579,23,46,.500,46,116,162,54,24,42,36,78,221
2020,Dewan Hernandez,C,23,TOR,6,0,28,5,14,.357,1,2,.500,4,12,.333,.393,3,5,.600,5,9,14,3,1,0,3,6,14
2020,Juancho Hernangómez,PF,24,TOT,48,14,833,100,247,.405,44,129,.341,56,118,.475,.494,44,71,.620,43,154,197,40,19,9,32,64,288
2020,Willy Hernangómez,C,25,CHO,31,0,375,74,139,.532,5,22,.227,69,117,.590,.550,37,59,.627,43,91,134,29,10,7,30,32,190
2020,Tyler Herro,SG,20,MIA,55,8,1508,270,631,.428,116,298,.389,154,333,.462,.520,87,100,.870,16,208,224,121,34,9,87,76,743
2020,Kevin Hervey,PF,23,OKC,10,0,52,7,27,.259,3,20,.150,4,7,.571,.315,0,0,,1,11,12,5,1,1,0,4,17
2020,Mario Hezonja,PF,24,POR,53,4,871,92,218,.422,24,78,.308,68,140,.486,.477,48,59,.814,30,154,184,50,36,9,42,107,256
2020,Buddy Hield,SG,27,SAC,72,44,2216,498,1162,.429,271,688,.394,227,474,.479,.545,115,136,.846,57,271,328,213,66,17,168,165,1382
2020,George Hill,PG,33,MIL,59,2,1271,194,376,.516,81,176,.460,113,200,.565,.624,85,101,.842,50,127,177,180,47,5,57,84,554
2020,Solomon Hill,PF,28,TOT,59,4,1088,110,278,.396,63,171,.368,47,107,.439,.509,40,54,.741,29,136,165,104,43,12,51,85,323
2020,Jaylen Hoard,PF,20,POR,13,0,103,15,32,.469,0,3,.000,15,29,.517,.469,8,13,.615,14,18,32,4,5,0,4,12,38
2020,Aaron Holiday,PG,23,IND,66,33,1617,233,563,.414,87,221,.394,146,342,.427,.491,74,87,.851,22,134,156,225,55,16,88,120,627
2020,Jrue Holiday,SG,29,NOP,61,61,2117,458,1006,.455,122,346,.353,336,660,.509,.516,129,182,.709,77,216,293,408,99,48,184,145,1167
2020,Justin Holiday,SF,30,IND,73,6,1826,208,486,.428,134,331,.405,74,155,.477,.566,53,67,.791,32,206,238,93,87,46,44,137,603
2020,Rondae Hollis-Jefferson,PF,25,TOR,60,6,1122,155,329,.471,3,23,.130,152,306,.497,.476,105,143,.734,110,173,283,106,46,23,59,115,418
2020,Richaun Holmes,C,26,SAC,44,38,1242,223,344,.648,0,0,,223,344,.648,.648,93,118,.788,127,231,358,42,41,56,52,169,539
2020,Rodney Hood,SF,27,POR,21,21,619,87,172,.506,35,71,.493,52,101,.515,.608,21,27,.778,10,62,72,32,17,4,19,46,230
2020,Al Horford,C,33,PHI,67,61,2025,319,709,.450,99,283,.350,220,426,.516,.520,61,80,.763,103,353,456,270,52,61,80,142,798
2020,Talen Horton-Tucker,SG,19,LAL,6,1,81,14,30,.467,4,13,.308,10,17,.588,.533,2,4,.500,2,5,7,6,8,1,6,10,34
2020,Danuel House Jr.,SF,26,HOU,63,52,1913,230,539,.427,129,355,.363,101,184,.549,.546,73,90,.811,57,210,267,85,67,34,54,132,662
2020,Dwight Howard,C,34,LAL,69,2,1306,202,277,.729,3,5,.600,199,272,.732,.735,110,214,.514,172,335,507,45,31,79,84,222,517
2020,William Howard,PF,26,HOU,2,0,13,0,4,.000,0,4,.000,0,0,,.000,0,0,,0,2,2,1,0,0,1,1,0
2020,Kevin Huerter,SG,21,ATL,56,48,1760,252,610,.413,127,334,.380,125,276,.453,.517,53,64,.828,35,193,228,213,51,27,87,139,684
2020,De'Andre Hunter,SF,22,ATL,63,62,2018,280,683,.410,108,304,.355,172,379,.454,.489,110,144,.764,44,242,286,112,44,18,103,182,778
2020,Chandler Hutchison,SF,23,CHI,28,10,527,80,175,.457,12,38,.316,68,137,.496,.491,46,78,.590,18,90,108,26,27,7,27,47,218
2020,Serge Ibaka,C,30,TOR,55,27,1485,343,670,.512,70,182,.385,273,488,.559,.564,89,124,.718,114,338,452,77,28,46,109,153,845
2020,Andre Iguodala,SF,36,MIA,21,0,418,38,88,.432,14,47,.298,24,41,.585,.511,6,15,.400,17,61,78,51,14,21,26,35,96
2020,Ersan İlyasova,PF,32,MIL,63,8,986,146,313,.466,50,137,.365,96,176,.545,.546,72,87,.828,62,240,302,49,24,17,34,95,414
2020,Joe Ingles,PF,32,UTA,72,45,2137,246,553,.445,141,353,.399,105,200,.525,.572,74,94,.787,27,251,278,373,65,11,142,154,707
2020,Brandon Ingram,PF,22,NOP,62,62,2104,507,1096,.463,150,384,.391,357,712,.501,.531,313,368,.851,51,329,380,259,61,38,189,179,1477
2020,Kyrie Irving,PG,27,BRK,20,20,658,199,416,.478,56,142,.394,143,274,.522,.546,94,102,.922,22,81,103,128,27,10,52,53,548
2020,Jonathan Isaac,PF,22,ORL,34,32,980,156,332,.470,32,94,.340,124,238,.521,.518,60,77,.779,58,173,231,48,53,78,49,83,404
2020,Wes Iwundu,SF,25,ORL,52,21,953,97,233,.416,28,82,.341,69,151,.457,.476,78,97,.804,24,107,131,60,25,13,26,80,300
2020,Frank Jackson,PG,21,NOP,59,2,797,134,331,.405,47,144,.326,87,187,.465,.476,56,75,.747,22,61,83,61,17,4,49,77,371
2020,Jaren Jackson Jr.,C,20,MEM,57,57,1622,353,753,.469,145,368,.394,208,385,.540,.565,139,186,.747,55,207,262,78,40,92,99,232,990
2020,Josh Jackson,SF,22,MEM,22,0,381,70,159,.440,23,72,.319,47,87,.540,.513,35,50,.700,11,55,66,35,18,9,28,40,198
2020,Justin Jackson,PF,24,DAL,65,3,1045,135,341,.396,48,163,.294,87,178,.489,.466,42,50,.840,27,127,154,52,15,10,14,69,360
2020,Reggie Jackson,SG-PG,29,TOT,31,16,743,134,326,.411,57,145,.393,77,181,.425,.498,45,54,.833,17,75,92,126,13,5,51,59,370
2020,Justin James,SF,23,SAC,36,0,232,35,84,.417,9,29,.310,26,55,.473,.470,10,21,.476,6,26,32,18,6,9,8,17,89
2020,LeBron James,PG,35,LAL,67,67,2316,643,1303,.493,148,425,.348,495,878,.564,.550,264,381,.693,66,459,525,684,78,36,261,118,1698
2020,Amile Jefferson,PF,26,ORL,18,0,74,5,14,.357,0,0,,5,14,.357,.357,5,14,.357,10,13,23,4,1,3,3,7,15
2020,DaQuan Jeffries,SG,22,SAC,13,0,141,20,40,.500,5,18,.278,15,22,.682,.563,5,6,.833,3,15,18,7,4,1,2,19,50
2020,Ty Jerome,SG,22,PHO,31,0,328,38,113,.336,14,50,.280,24,63,.381,.398,12,16,.750,7,39,46,44,15,3,18,29,102
2020,Alize Johnson,PF,23,IND,17,1,118,12,29,.414,3,8,.375,9,21,.429,.466,7,10,.700,16,32,48,7,3,2,7,12,34
2020,B.J. Johnson,SF,24,ORL,10,0,83,9,32,.281,3,9,.333,6,23,.261,.328,9,10,.900,3,12,15,3,3,0,6,3,30
2020,Cameron Johnson,PF,23,PHO,57,9,1255,176,405,.435,106,272,.390,70,133,.526,.565,46,57,.807,49,138,187,69,36,20,32,88,504
2020,James Johnson,PF-C,32,TOT,32,1,619,103,215,.479,33,91,.363,70,124,.565,.556,31,48,.646,25,93,118,74,25,32,48,80,270
2020,Keldon Johnson,SF,20,SAS,17,1,301,53,89,.596,13,22,.591,40,67,.597,.669,35,44,.795,10,47,57,15,14,2,13,28,154
2020,Stanley Johnson,PF,23,TOR,25,0,150,22,59,.373,7,24,.292,15,35,.429,.432,9,16,.563,7,30,37,20,6,4,15,16,60
2020,Tyler Johnson,PG-SG,27,TOT,39,7,709,97,250,.388,38,119,.319,59,131,.450,.464,42,50,.840,18,58,76,74,16,9,29,58,274
2020,Nikola Jokić,C,24,DEN,73,73,2336,565,1071,.528,80,255,.314,485,816,.594,.565,246,301,.817,166,545,711,512,85,44,226,222,1456
2020,Damian Jones,C,24,ATL,55,27,887,121,178,.680,2,9,.222,119,169,.704,.685,62,84,.738,74,132,206,35,26,40,28,149,306
2020,Derrick Jones Jr.,SF,22,MIA,59,16,1375,184,349,.527,37,132,.280,147,217,.677,.580,95,123,.772,66,167,233,62,58,38,30,130,500
2020,Tyus Jones,PG,23,MEM,65,6,1232,197,429,.459,47,124,.379,150,305,.492,.514,43,58,.741,9,94,103,285,59,6,55,44,484
2020,DeAndre Jordan,C,31,BRK,56,6,1234,191,287,.666,0,0,,191,287,.666,.666,83,122,.680,141,420,561,105,18,52,74,114,465
2020,Cory Joseph,PG,28,SAC,72,26,1759,171,412,.415,56,159,.352,115,253,.455,.483,60,70,.857,44,144,188,251,53,21,80,133,458
2020,Mfiondu Kabengele,C,22,LAC,12,0,64,14,32,.438,9,20,.450,5,12,.417,.578,5,5,1.000,1,10,11,2,2,2,2,9,42
2020,Frank Kaminsky,C,26,PHO,39,13,777,138,307,.450,41,124,.331,97,183,.530,.516,61,90,.678,35,141,176,75,14,10,37,75,378
2020,Luke Kennard,SG,23,DET,28,25,922,151,342,.442,73,183,.399,78,159,.491,.548,67,75,.893,9,89,98,115,12,6,43,65,442
2020,Stanton Kidd,SG,27,UTA,4,0,15,0,3,.000,0,1,.000,0,2,.000,.000,0,0,,0,3,3,1,0,0,2,3,0
2020,Michael Kidd-Gilchrist,PF,26,TOT,25,0,281,22,66,.333,5,20,.250,17,46,.370,.371,11,14,.786,14,53,67,14,2,6,16,37,60
2020,Louis King,SF,20,DET,10,0,62,8,21,.381,4,11,.364,4,10,.400,.476,0,3,.000,1,9,10,5,2,0,2,10,20
2020,Maxi Kleber,PF,28,DAL,74,21,1890,237,514,.461,119,319,.373,118,195,.605,.577,79,93,.849,112,276,388,88,25,83,58,176,672
2020,Brandon Knight,SG-PG,28,TOT,25,3,462,59,167,.353,45,131,.344,14,36,.389,.488,20,34,.588,4,37,41,69,10,3,38,40,183
2020,Kevin Knox,SF,20,NYK,65,4,1166,144,401,.359,65,199,.327,79,202,.391,.440,66,101,.653,28,156,184,61,23,28,45,106,419
2020,John Konchar,SG,23,MEM,19,0,181,24,37,.649,5,10,.500,19,27,.704,.716,1,2,.500,18,29,47,22,7,3,7,7,54
2020,Furkan Korkmaz,SG,22,PHI,72,12,1559,242,563,.430,143,356,.402,99,207,.478,.557,77,102,.755,18,150,168,79,41,16,59,98,704
2020,Luke Kornet,C,24,CHI,36,14,559,82,187,.439,31,108,.287,51,79,.646,.521,20,28,.714,22,62,84,32,11,26,14,54,215
2020,Kyle Korver,SF,38,MIL,58,1,960,126,293,.430,99,237,.418,27,56,.482,.599,35,41,.854,15,107,122,68,26,12,48,78,386
2020,Rodions Kurucs,PF,21,BRK,47,9,684,79,177,.446,33,90,.367,46,87,.529,.540,24,38,.632,25,112,137,51,25,5,46,90,215
2020,Kyle Kuzma,PF,24,LAL,61,9,1526,291,668,.436,86,272,.316,205,396,.518,.500,114,155,.735,52,221,273,80,28,26,91,126,782
2020,Skal Labissière,C,23,POR,33,1,567,81,147,.551,3,13,.231,78,134,.582,.561,25,33,.758,65,104,169,42,7,31,30,89,190
2020,Jeremy Lamb,SG,27,IND,46,42,1291,216,479,.451,53,158,.335,163,321,.508,.506,92,110,.836,24,176,200,96,55,22,50,104,577
2020,Romeo Langford,SG,20,BOS,32,2,370,28,80,.350,5,27,.185,23,53,.434,.381,18,25,.720,15,26,41,13,8,8,11,33,79
2020,Zach LaVine,SF,24,CHI,60,60,2085,539,1199,.450,184,484,.380,355,715,.497,.526,268,334,.802,41,248,289,254,88,28,206,131,1530
2020,Vic Law,PF,24,ORL,8,0,62,6,18,.333,1,7,.143,5,11,.455,.361,2,6,.333,2,9,11,3,2,0,2,6,15
2020,Jake Layman,SF,25,MIN,23,2,505,81,179,.453,24,72,.333,57,107,.533,.520,24,32,.750,17,40,57,15,17,10,24,47,210
2020,T.J. Leaf,PF,22,IND,28,1,222,36,86,.419,5,18,.278,31,68,.456,.448,7,16,.438,23,48,71,9,10,4,8,22,84
2020,Jalen Lecque,SG,19,PHO,5,0,32,4,10,.400,0,4,.000,4,6,.667,.400,2,2,1.000,0,2,2,2,0,0,2,3,10
2020,Courtney Lee,SG,34,DAL,24,9,345,40,82,.488,21,47,.447,19,35,.543,.616,6,7,.857,7,25,32,12,18,6,11,33,107
2020,Damion Lee,SG,27,GSW,49,36,1423,213,511,.417,85,239,.356,128,272,.471,.500,110,126,.873,32,207,239,133,50,6,67,116,621
2020,Alex Len,C,26,TOT,55,12,970,177,319,.555,16,59,.271,161,260,.619,.580,68,105,.648,100,221,321,50,23,48,55,127,438
2020,Kawhi Leonard,SF,28,LAC,57,57,1848,532,1133,.470,123,325,.378,409,808,.506,.524,356,402,.886,54,348,402,280,103,33,149,113,1543
2020,Meyers Leonard,C,27,MIA,51,49,1034,119,234,.509,53,128,.414,66,106,.623,.622,18,28,.643,30,230,260,55,14,15,39,107,309
2020,Caris LeVert,SG,25,BRK,45,31,1330,311,732,.425,80,220,.364,231,512,.451,.480,140,197,.711,49,140,189,199,53,10,118,81,842
2020,Damian Lillard,PG,29,POR,66,66,2474,624,1349,.463,270,674,.401,354,675,.524,.563,460,518,.888,33,251,284,530,70,22,194,114,1978
2020,Nassir Little,PF,19,POR,48,5,573,65,151,.430,14,59,.237,51,92,.554,.477,28,44,.636,31,77,108,22,13,14,15,72,172
2020,Kevon Looney,C,23,GSW,20,4,262,29,79,.367,1,14,.071,28,65,.431,.373,9,12,.750,28,38,66,20,12,6,12,34,68
2020,Brook Lopez,C,31,MIL,68,67,1817,292,671,.435,102,325,.314,190,346,.549,.511,127,152,.836,58,254,312,99,46,163,70,163,813
2020,Robin Lopez,C,31,MIL,66,5,958,147,299,.492,35,105,.333,112,194,.577,.550,28,53,.528,56,105,161,45,10,45,63,96,357
2020,Kevin Love,PF,31,CLE,56,56,1780,327,727,.450,146,390,.374,181,337,.537,.550,187,219,.854,54,493,547,178,33,19,140,90,987
2020,Kyle Lowry,PG,33,TOR,58,58,2098,334,803,.416,164,466,.352,170,337,.504,.518,294,343,.857,32,260,292,433,82,26,178,190,1126
2020,Timothé Luwawu-Cabarrot,SF,24,BRK,47,2,853,117,269,.435,62,160,.388,55,109,.505,.550,69,81,.852,29,98,127,29,18,7,37,106,365
2020,Trey Lyles,PF,24,SAS,63,53,1271,153,343,.446,65,168,.387,88,175,.503,.541,33,45,.733,71,290,361,69,28,28,39,98,404
2020,Daryl Macon,PG,24,MIA,4,0,14,1,3,.333,1,2,.500,0,1,.000,.500,0,0,,0,0,0,1,0,0,2,1,3
2020,J.P. Macura,SG,24,CLE,1,0,1,0,0,,0,0,,0,0,,,0,0,,0,0,0,0,0,0,0,0,0
2020,Josh Magette,PG,30,ORL,8,0,38,5,15,.333,1,4,.250,4,11,.364,.367,1,2,.500,1,5,6,5,3,1,5,4,12
2020,Ian Mahinmi,C,33,WAS,38,35,808,104,210,.495,5,26,.192,99,184,.538,.507,70,113,.619,78,140,218,49,31,44,45,114,283
2020,Thon Maker,C,22,DET,60,14,776,93,193,.482,22,64,.344,71,129,.550,.539,73,110,.664,54,113,167,43,25,39,45,102,281
2020,Terance Mann,SF,23,LAC,41,6,362,37,79,.468,7,20,.350,30,59,.508,.513,18,27,.667,10,45,55,53,11,5,18,46,99
2020,Boban Marjanović,C,31,DAL,44,5,422,121,211,.573,4,17,.235,117,194,.603,.583,43,57,.754,66,131,197,20,8,10,30,56,289
2020,Lauri Markkanen,PF,22,CHI,50,50,1492,251,591,.425,109,317,.344,142,274,.518,.517,126,153,.824,60,253,313,74,42,23,81,96,737
2020,Caleb Martin,SF,24,CHO,18,1,317,37,84,.440,20,37,.541,17,47,.362,.560,17,21,.810,10,28,38,23,12,7,15,32,111
2020,Cody Martin,SF,24,CHO,48,3,903,89,207,.430,18,77,.234,71,130,.546,.473,42,65,.646,38,120,158,95,39,9,44,78,238
2020,Jeremiah Martin,PG,23,BRK,9,0,99,24,53,.453,5,18,.278,19,35,.543,.500,11,14,.786,1,9,10,18,7,2,4,7,64
2020,Kelan Martin,SF,24,MIN,31,4,495,71,181,.392,25,96,.260,46,85,.541,.461,30,31,.968,12,84,96,23,7,9,20,51,197
2020,Frank Mason III,PG,25,MIL,9,0,118,23,51,.451,6,21,.286,17,30,.567,.510,10,17,.588,5,14,19,29,5,1,11,11,62
2020,Garrison Mathews,SG,23,WAS,18,0,227,24,56,.429,19,46,.413,5,10,.500,.598,31,34,.912,6,18,24,10,8,1,8,32,98
2020,Wesley Matthews,SG,33,MIL,67,67,1635,167,422,.396,108,297,.364,59,125,.472,.524,52,68,.765,22,144,166,92,38,9,43,103,494
2020,Luc Mbah a Moute,PF,33,HOU,3,0,25,2,5,.400,0,2,.000,2,3,.667,.400,1,2,.500,1,1,2,0,2,0,1,0,5
2020,Patrick McCaw,SF,24,TOR,37,12,908,67,162,.414,23,71,.324,44,91,.484,.485,13,18,.722,19,67,86,79,39,4,29,60,170
2020,CJ McCollum,SG,28,POR,70,70,2556,611,1356,.451,194,512,.379,417,844,.494,.522,140,185,.757,46,251,297,310,54,42,127,183,1556
2020,T.J. McConnell,PG,27,IND,71,3,1326,212,411,.516,5,17,.294,207,394,.525,.522,35,42,.833,38,151,189,355,56,11,100,73,464
2020,Jalen McDaniels,SF,22,CHO,16,0,293,33,70,.471,9,24,.375,24,46,.522,.536,14,17,.824,15,50,65,13,8,3,11,36,89
2020,Doug McDermott,PF,28,IND,69,0,1372,267,547,.488,128,294,.435,139,253,.549,.605,48,58,.828,26,148,174,78,12,5,42,117,710
2020,JaVale McGee,C,32,LAL,68,68,1130,195,306,.637,3,6,.500,192,300,.640,.642,53,82,.646,125,265,390,37,36,94,55,159,446
2020,Rodney McGruder,SG,28,LAC,56,4,871,72,181,.398,24,89,.270,48,92,.522,.464,19,34,.559,29,122,151,36,26,8,24,74,187
2020,Alfonzo McKinnie,SF,27,CLE,40,1,593,73,171,.427,14,65,.215,59,106,.557,.468,22,31,.710,37,76,113,14,23,8,26,72,182
2020,Jordan McLaughlin,PG,23,MIN,30,2,590,87,178,.489,29,76,.382,58,102,.569,.570,26,39,.667,7,42,49,125,34,4,31,31,229
2020,Ben McLemore,SF,26,HOU,71,23,1619,242,545,.444,181,452,.400,61,93,.656,.610,50,67,.746,21,136,157,58,45,16,50,155,715
2020,Jordan McRae,SG,28,TOT,37,4,784,149,366,.407,45,126,.357,104,240,.433,.469,83,109,.761,18,106,124,93,21,16,43,73,426
2020,Nicolò Melli,C,29,NOP,60,8,1042,136,323,.421,69,206,.335,67,117,.573,.528,54,73,.740,38,142,180,82,34,23,46,124,395
2020,De'Anthony Melton,PG,21,MEM,60,8,1167,161,401,.401,40,140,.286,121,261,.464,.451,93,121,.769,43,177,220,175,77,20,84,109,455
2020,Chimezie Metu,C,22,SAS,18,0,105,24,42,.571,0,2,.000,24,40,.600,.571,10,13,.769,12,21,33,10,3,6,10,7,58
2020,Khris Middleton,SF,28,MIL,62,59,1853,471,947,.497,147,354,.415,324,593,.546,.575,208,227,.916,44,338,382,265,53,7,137,142,1297
2020,Eric Mika,C,25,SAC,1,0,19,2,3,.667,0,0,,2,3,.667,.667,2,2,1.000,2,5,7,0,0,0,0,5,6
2020,C.J. Miles,SF,32,WAS,10,0,161,19,59,.322,11,35,.314,8,24,.333,.415,15,20,.750,4,8,12,12,10,4,4,14,64
2020,Malcolm Miller,SF,26,TOR,28,1,162,12,29,.414,8,22,.364,4,7,.571,.552,3,8,.375,2,14,16,11,5,2,4,18,35
2020,Patty Mills,PG,31,SAS,66,1,1485,258,598,.431,154,403,.382,104,195,.533,.560,97,112,.866,22,86,108,118,53,6,54,105,767
2020,Paul Millsap,PF,34,DEN,51,48,1240,211,438,.482,54,124,.435,157,314,.500,.543,115,141,.816,98,195,293,83,44,30,70,150,591
2020,Shake Milton,SG,23,PHI,40,24,805,134,277,.484,58,135,.430,76,142,.535,.588,51,65,.785,15,73,88,104,20,7,47,92,377
2020,Donovan Mitchell,SG,23,UTA,69,69,2364,602,1342,.449,173,473,.366,429,869,.494,.513,278,322,.863,53,251,304,294,70,14,184,172,1655
2020,Naz Mitrou-Long,SG,26,IND,5,0,47,6,17,.353,2,12,.167,4,5,.800,.412,0,0,,0,7,7,8,1,1,3,2,14
2020,Adam Mokoka,SF,21,CHI,11,0,112,12,28,.429,6,15,.400,6,13,.462,.536,2,4,.500,7,3,10,4,4,0,2,17,32
2020,Malik Monk,SG,21,CHO,55,1,1169,212,488,.434,58,204,.284,154,284,.542,.494,82,100,.820,27,130,157,114,25,16,77,74,564
2020,Matt Mooney,SG,22,CLE,4,0,19,1,4,.250,0,2,.000,1,2,.500,.250,0,0,,0,3,3,1,2,1,0,1,2
2020,E'Twaun Moore,SG,30,NOP,56,6,1020,186,437,.426,63,167,.377,123,270,.456,.498,31,45,.689,31,100,131,78,32,11,40,80,466
2020,Ja Morant,PG,20,MEM,67,67,2074,447,937,.477,60,179,.335,387,758,.511,.509,239,308,.776,51,208,259,488,58,18,220,110,1193
2020,Juwan Morgan,PF,22,UTA,21,0,134,15,26,.577,3,8,.375,12,18,.667,.635,3,4,.750,10,19,29,6,1,2,6,19,36
2020,Marcus Morris,SF-PF,30,TOT,62,62,1936,355,810,.438,142,348,.408,213,462,.461,.526,181,220,.823,59,252,311,86,47,30,97,180,1033
2020,Markieff Morris,PF,30,TOT,58,17,1187,203,458,.443,88,228,.386,115,230,.500,.539,66,85,.776,40,178,218,77,31,17,76,133,560
2020,Monte Morris,PG,24,DEN,73,12,1636,260,566,.459,65,172,.378,195,394,.495,.517,75,89,.843,24,113,137,255,55,17,53,73,660
2020,Johnathan Motley,PF,24,LAC,13,0,41,11,15,.733,1,1,1.000,10,14,.714,.767,5,7,.714,3,7,10,8,3,0,5,6,28
2020,Emmanuel Mudiay,PG,23,UTA,54,2,850,151,327,.462,30,87,.345,121,240,.504,.508,63,83,.759,18,108,126,116,24,10,76,72,395
2020,Mychal Mulder,SF,25,GSW,7,3,204,26,67,.388,16,52,.308,10,15,.667,.507,9,12,.750,3,20,23,8,2,1,5,20,77
2020,Dejounte Murray,PG,23,SAS,66,58,1687,294,637,.462,41,111,.369,253,526,.481,.494,91,114,.798,69,314,383,271,111,17,125,143,720
2020,Jamal Murray,PG,22,DEN,59,59,1904,408,894,.456,112,324,.346,296,570,.519,.519,163,185,.881,45,191,236,284,67,17,127,102,1091
2020,Džanan Musa,SF,20,BRK,40,0,487,64,172,.372,19,78,.244,45,94,.479,.427,45,60,.750,21,65,86,43,15,1,36,30,192
2020,Mike Muscala,C,28,OKC,47,2,572,77,189,.407,54,143,.378,23,46,.500,.550,18,22,.818,16,92,108,40,9,12,17,58,226
2020,Svi Mykhailiuk,SF,22,DET,56,27,1265,166,405,.410,115,285,.404,51,120,.425,.552,57,70,.814,17,87,104,106,41,4,61,87,504
2020,Abdel Nader,SF,26,OKC,55,6,867,123,263,.468,48,128,.375,75,135,.556,.559,51,66,.773,14,86,100,38,23,20,43,78,345
2020,Larry Nance Jr.,PF,27,CLE,56,10,1472,229,431,.531,56,159,.352,173,272,.636,.596,50,74,.676,106,303,409,123,56,22,60,91,564
2020,Shabazz Napier,PG,28,TOT,56,32,1344,188,456,.412,76,240,.317,112,216,.519,.496,126,153,.824,26,132,158,262,69,11,128,101,578
2020,Raul Neto,PG,27,PHI,54,3,668,101,222,.455,34,88,.386,67,134,.500,.532,39,47,.830,11,50,61,95,24,6,47,50,275
2020,Malik Newman,SG,22,CLE,1,0,4,0,2,.000,0,1,.000,0,1,.000,.000,2,2,1.000,0,0,0,0,0,0,1,0,2
2020,Georges Niang,PF,26,UTA,66,1,923,141,322,.438,90,225,.400,51,97,.526,.578,20,24,.833,15,112,127,44,18,5,30,75,392
2020,Joakim Noah,C,34,LAC,5,0,50,4,8,.500,0,0,,4,8,.500,.500,6,8,.750,5,11,16,7,1,1,6,9,14
2020,Nerlens Noel,C,25,OKC,61,7,1127,184,269,.684,1,3,.333,183,266,.688,.686,80,106,.755,91,209,300,57,59,91,66,166,449
2020,Zach Norvell,SG,22,TOT,5,0,41,3,12,.250,3,8,.375,0,4,.000,.375,1,1,1.000,0,6,6,3,2,0,3,4,10
2020,Jaylen Nowell,SG,20,MIN,15,0,151,19,53,.358,3,26,.115,16,27,.593,.387,16,17,.941,3,10,13,19,3,1,3,11,57
2020,Frank Ntilikina,PG,21,NYK,57,26,1187,131,333,.393,44,137,.321,87,196,.444,.459,51,59,.864,23,98,121,172,54,16,71,142,357
2020,Kendrick Nunn,PG,24,MIA,67,67,1962,401,914,.439,137,391,.350,264,523,.505,.514,85,100,.850,21,159,180,220,56,15,114,152,1024
2020,Jusuf Nurkić,C,25,POR,8,8,253,54,109,.495,2,10,.200,52,99,.525,.505,31,35,.886,23,59,82,32,11,16,19,39,141
2020,David Nwaba,SF,27,BRK,20,0,268,37,71,.521,12,28,.429,25,43,.581,.606,18,27,.667,8,37,45,8,11,12,8,32,104
2020,Royce O'Neale,SF,26,UTA,71,62,2049,158,365,.433,92,244,.377,66,121,.545,.559,42,55,.764,27,362,389,180,59,32,61,202,450
2020,Kyle O'Quinn,C,29,PHI,29,2,313,42,85,.494,7,27,.259,35,58,.603,.535,11,20,.550,34,82,116,51,7,24,20,37,102
2020,Semi Ojeleye,PF,25,BOS,69,6,1011,80,196,.408,48,127,.378,32,69,.464,.531,28,32,.875,26,119,145,37,21,5,19,80,236
2020,Jahlil Okafor,C,24,NOP,30,9,467,101,162,.623,1,3,.333,100,159,.629,.627,40,62,.645,48,79,127,37,7,22,38,67,243
2020,Elie Okobo,PG,22,PHO,55,3,719,72,181,.398,25,71,.352,47,110,.427,.467,50,71,.704,16,74,90,115,24,4,38,54,219
2020,Josh Okogie,SG,21,MIN,62,28,1547,170,398,.427,41,154,.266,129,244,.529,.479,152,191,.796,87,181,268,99,68,26,87,139,533
2020,KZ Okpala,PF,20,MIA,5,0,26,3,5,.600,0,1,.000,3,4,.750,.600,1,2,.500,1,4,5,1,2,1,1,2,7
2020,Victor Oladipo,SG,27,IND,19,16,528,97,246,.394,33,104,.317,64,142,.451,.461,48,59,.814,9,66,75,56,17,4,47,36,275
2020,Kelly Olynyk,C,28,MIA,67,9,1300,184,398,.462,95,234,.406,89,164,.543,.582,86,100,.860,44,261,305,116,45,23,71,173,549
2020,Miye Oni,SF,22,UTA,10,1,109,12,32,.375,7,19,.368,5,13,.385,.484,4,5,.800,5,12,17,4,4,2,4,9,35
2020,Cedi Osman,SF,24,CLE,65,65,1910,266,609,.437,123,321,.383,143,288,.497,.538,63,94,.670,39,192,231,154,54,16,91,160,718
2020,Kelly Oubre Jr.,SF,24,PHO,56,55,1933,373,826,.452,108,307,.352,265,519,.511,.517,192,246,.780,67,294,361,85,71,40,83,192,1046
2020,Tariq Owens,PF,24,PHO,3,0,15,1,5,.200,0,2,.000,1,3,.333,.200,2,2,1.000,2,1,3,0,1,0,0,1,4
2020,Jeremy Pargo,PG,33,GSW,3,0,44,11,22,.500,3,7,.429,8,15,.533,.568,0,1,.000,1,2,3,8,1,0,4,8,25
2020,Jabari Parker,PF,24,TOT,38,23,917,219,429,.510,32,119,.269,187,310,.603,.548,61,81,.753,61,153,214,68,45,16,64,99,531
2020,Chandler Parsons,PF,31,ATL,5,0,54,5,18,.278,4,14,.286,1,4,.250,.389,0,0,,1,6,7,3,4,1,3,3,14
2020,Eric Paschall,PF,23,GSW,60,26,1654,318,640,.497,37,129,.287,281,511,.550,.526,164,212,.774,82,193,275,127,32,13,94,125,837
2020,Anžejs Pasečņiks,C,24,WAS,27,0,437,61,116,.526,0,3,.000,61,113,.540,.526,34,58,.586,42,65,107,18,9,12,24,75,156
2020,Patrick Patterson,PF,30,LAC,59,18,776,95,233,.408,67,172,.390,28,61,.459,.552,35,43,.814,35,116,151,41,7,3,21,54,292
2020,Justin Patton,C,22,OKC,5,0,24,4,10,.400,1,4,.250,3,6,.500,.450,0,0,,1,4,5,2,0,0,2,4,9
2020,Chris Paul,PG,34,OKC,70,70,2208,434,887,.489,111,304,.365,323,583,.554,.552,253,279,.907,26,323,349,472,111,11,161,158,1232
2020,Cameron Payne,SG,25,PHO,8,0,183,33,68,.485,15,29,.517,18,39,.462,.596,6,7,.857,4,27,31,24,8,2,11,20,87
2020,Elfrid Payton,PG,25,NYK,45,36,1246,193,440,.439,14,69,.203,179,371,.482,.455,49,86,.570,52,160,212,323,70,17,96,89,449
2020,Gary Payton II,SF,27,WAS,29,17,432,48,116,.414,13,46,.283,35,70,.500,.470,4,8,.500,26,54,80,48,33,7,20,54,113
2020,Norvel Pelle,C,26,PHI,24,0,232,25,48,.521,0,1,.000,25,47,.532,.521,7,14,.500,20,52,72,8,3,31,18,55,57
2020,Theo Pinson,SG,24,BRK,33,0,365,45,155,.290,15,80,.188,30,75,.400,.339,15,16,.938,10,44,54,56,17,4,33,35,120
2020,Mason Plumlee,C,29,DEN,61,1,1057,177,288,.615,0,5,.000,177,283,.625,.615,83,155,.535,98,219,317,154,33,38,82,143,437
2020,Jakob Poeltl,C,24,SAS,66,18,1171,166,266,.624,0,0,,166,266,.624,.624,40,86,.465,131,244,375,116,37,95,54,126,372
2020,Vincent Poirier,C,26,BOS,22,0,130,17,36,.472,1,2,.500,16,34,.471,.486,6,7,.857,13,30,43,8,2,9,8,25,41
2020,Shamorie Ponds,PG,21,TOR,4,0,11,3,5,.600,1,2,.500,2,3,.667,.700,2,2,1.000,0,1,1,2,0,1,0,2,9
2020,Jordan Poole,SG,20,GSW,57,14,1274,167,502,.333,74,265,.279,93,237,.392,.406,95,119,.798,9,109,118,134,35,10,74,94,503
2020,Kevin Porter Jr.,SF,19,CLE,50,3,1162,186,421,.442,53,158,.335,133,263,.506,.505,73,101,.723,22,140,162,109,46,14,93,135,498
2020,Michael Porter Jr.,SF,21,DEN,55,8,903,195,383,.509,62,147,.422,133,236,.564,.590,60,72,.833,66,193,259,46,27,25,49,100,512
2020,Otto Porter Jr.,SF,26,CHI,14,9,331,62,140,.443,24,62,.387,38,78,.487,.529,19,27,.704,13,35,48,25,15,6,11,31,167
2020,Bobby Portis,PF,24,NYK,66,5,1393,265,589,.450,67,187,.358,198,402,.493,.507,71,93,.763,80,258,338,98,32,18,73,110,668
2020,Kristaps Porziņģis,C,24,DAL,57,57,1814,398,932,.427,142,403,.352,256,529,.484,.503,226,283,.799,100,440,540,102,41,115,92,185,1164
2020,Dwight Powell,C,28,DAL,40,37,1061,146,229,.638,10,39,.256,136,190,.716,.659,74,111,.667,75,152,227,59,34,22,36,102,376
2020,Norman Powell,SG,26,TOR,52,26,1479,296,598,.495,109,273,.399,187,325,.575,.586,129,153,.843,26,164,190,91,60,21,77,108,830
2020,Taurean Prince,PF,25,BRK,64,61,1857,278,739,.376,146,431,.339,132,308,.429,.475,71,89,.798,50,331,381,116,57,25,127,159,773
2020,Chasson Randle,PG,26,GSW,3,0,40,0,4,.000,0,2,.000,0,2,.000,.000,5,6,.833,0,2,2,5,2,0,0,3,5
2020,Julius Randle,PF,25,NYK,64,64,2080,463,1006,.460,64,231,.277,399,775,.515,.492,258,352,.733,151,471,622,198,51,22,193,178,1248
2020,Josh Reaves,SF,22,DAL,4,0,28,3,9,.333,0,2,.000,3,7,.429,.333,2,2,1.000,1,2,3,3,0,0,0,5,8
2020,Cam Reddish,SF,20,ATL,58,34,1551,213,554,.384,83,250,.332,130,304,.428,.459,101,126,.802,35,181,216,87,62,28,96,132,610
2020,J.J. Redick,SG,35,NOP,60,36,1581,286,631,.453,180,397,.453,106,234,.453,.596,165,185,.892,10,141,151,119,20,10,75,96,917
2020,Naz Reid,C,20,MIN,30,11,495,100,243,.412,32,97,.330,68,146,.466,.477,37,53,.698,34,90,124,35,19,22,22,83,269
2020,Josh Richardson,SG,26,PHI,55,53,1693,278,646,.430,85,249,.341,193,397,.486,.496,114,141,.809,41,133,174,162,52,36,104,136,755
2020,Austin Rivers,SG,27,HOU,68,4,1594,211,501,.421,96,270,.356,115,231,.498,.517,78,111,.703,27,148,175,113,49,10,50,129,596
2020,Andre Roberson,SF,28,OKC,7,0,87,8,29,.276,3,14,.214,5,15,.333,.328,1,2,.500,7,20,27,4,1,3,2,13,20
2020,Duncan Robinson,SG,25,MIA,73,68,2166,323,687,.470,270,606,.446,53,81,.654,.667,67,72,.931,10,222,232,102,35,19,70,193,983
2020,Glenn Robinson III,SF,26,TOT,62,52,1786,288,592,.486,77,197,.391,211,395,.534,.552,74,86,.860,81,189,270,96,54,16,55,100,727
2020,Jerome Robinson,SG,22,TOT,63,6,979,115,310,.371,49,153,.320,66,157,.420,.450,40,57,.702,13,116,129,87,28,17,49,112,319
2020,Justin Robinson,PG,22,WAS,9,0,49,5,12,.417,3,5,.600,2,7,.286,.542,0,0,,1,4,5,7,0,1,3,2,13
2020,Mitchell Robinson,C,21,NYK,61,7,1412,253,341,.742,0,0,,253,341,.742,.742,84,148,.568,186,242,428,36,52,119,37,194,590
2020,Isaiah Roby,PF,21,OKC,3,0,11,0,1,.000,0,0,,0,1,.000,.000,0,0,,0,2,2,0,0,0,1,1,0
2020,Rajon Rondo,PG,33,LAL,48,3,984,137,328,.418,41,125,.328,96,203,.473,.480,27,41,.659,23,119,142,240,40,2,91,58,342
2020,Derrick Rose,PG,31,DET,50,15,1298,369,753,.490,45,147,.306,324,606,.535,.520,121,139,.871,27,94,121,278,40,16,126,49,904
2020,Terrence Ross,SG,28,ORL,69,0,1889,341,846,.403,177,504,.351,164,342,.480,.508,157,184,.853,13,209,222,82,77,24,70,109,1016
2020,Terry Rozier,PG,25,CHO,63,63,2164,398,941,.423,172,423,.407,226,518,.436,.514,166,190,.874,50,226,276,259,61,10,141,126,1134
2020,Ricky Rubio,PG,29,PHO,65,65,2016,287,692,.415,78,216,.361,209,476,.439,.471,195,226,.863,46,258,304,570,94,11,173,167,847
2020,D'Angelo Russell,PG,23,TOT,45,45,1452,360,846,.426,158,431,.367,202,415,.487,.519,161,199,.809,17,160,177,285,48,13,147,86,1039
2020,Domantas Sabonis,PF,23,IND,62,62,2159,458,848,.540,17,67,.254,441,781,.565,.550,214,296,.723,189,582,771,310,47,30,170,195,1147
2020,Luka Šamanić,PF,20,SAS,3,1,48,5,16,.313,3,8,.375,2,8,.250,.406,3,4,.750,1,9,10,6,0,2,2,6,16
2020,JaKarr Sampson,PF,26,IND,34,12,471,68,115,.591,2,13,.154,66,102,.647,.600,18,27,.667,20,68,88,21,16,12,15,64,156
2020,Dario Šarić,PF,25,PHO,66,51,1632,256,538,.476,84,235,.357,172,303,.568,.554,108,128,.844,100,306,406,123,37,16,88,156,704
2020,Tomáš Satoranský,SG,28,CHI,65,64,1878,237,551,.430,64,199,.322,173,352,.491,.488,106,121,.876,76,178,254,354,80,7,130,135,644
2020,Admiral Schofield,PF,22,WAS,33,2,368,35,92,.380,19,61,.311,16,31,.516,.484,10,15,.667,7,40,47,15,8,4,7,50,99
2020,Dennis Schröder,PG,26,OKC,65,2,1999,453,965,.469,125,325,.385,328,640,.513,.534,198,236,.839,19,217,236,262,45,14,166,146,1229
2020,Mike Scott,PF,31,PHI,68,11,1207,149,350,.426,80,217,.369,69,133,.519,.540,30,37,.811,65,183,248,56,21,5,26,96,408
2020,Thabo Sefolosha,PF,35,HOU,41,0,436,37,91,.407,15,54,.278,22,37,.595,.489,3,8,.375,21,72,93,25,24,12,15,43,92
2020,Collin Sexton,PG,21,CLE,65,65,2143,513,1086,.472,97,255,.380,416,831,.501,.517,226,267,.846,61,143,204,192,65,7,158,142,1349
2020,Landry Shamet,SG,22,LAC,53,30,1452,158,391,.404,111,296,.375,47,95,.495,.546,65,76,.855,6,94,100,99,20,10,42,142,492
2020,Marial Shayok,SG,24,PHI,4,0,28,3,12,.250,2,6,.333,1,6,.167,.333,3,4,.750,1,6,7,1,0,1,3,4,11
2020,Iman Shumpert,SF,29,BRK,13,0,241,21,64,.328,8,33,.242,13,31,.419,.391,4,7,.571,9,25,34,12,12,2,10,21,54
2020,Pascal Siakam,PF,25,TOR,60,60,2110,500,1104,.453,131,365,.359,369,739,.499,.512,240,303,.792,64,375,439,207,61,53,148,170,1371
2020,Chris Silva,PF,23,MIA,44,0,346,48,78,.615,0,3,.000,48,75,.640,.615,37,55,.673,60,66,126,23,9,21,32,85,133
2020,Ben Simmons,PG,23,PHI,57,57,2017,375,647,.580,2,7,.286,373,640,.583,.581,185,298,.621,113,331,444,455,119,33,200,186,937
2020,Anfernee Simons,SG,20,POR,70,4,1449,214,536,.399,75,226,.332,139,310,.448,.469,76,92,.826,25,127,152,97,26,10,61,135,579
2020,Alen Smailagić,C,19,GSW,14,0,139,20,40,.500,3,13,.231,17,27,.630,.538,16,19,.842,10,17,27,13,3,4,11,14,59
2020,Marcus Smart,SG,25,BOS,60,40,1919,256,682,.375,137,395,.347,119,287,.415,.476,127,152,.836,42,183,225,291,101,29,103,162,776
2020,Dennis Smith Jr.,PG,22,NYK,34,3,537,72,211,.341,16,54,.296,56,157,.357,.379,27,53,.509,21,57,78,98,28,8,58,65,187
2020,Ish Smith,PG,31,WAS,68,23,1787,308,689,.447,62,169,.367,246,520,.473,.492,62,86,.721,30,189,219,334,59,30,95,106,740
2020,J.R. Smith,SG,34,LAL,6,0,79,7,22,.318,1,11,.091,6,11,.545,.341,2,2,1.000,0,5,5,3,1,0,4,5,17
2020,Zhaire Smith,SF,20,PHI,7,0,32,3,11,.273,0,3,.000,3,8,.375,.273,2,4,.500,0,2,2,2,3,0,2,4,8
2020,Tony Snell,SF,28,DET,59,57,1641,170,382,.445,102,254,.402,68,128,.531,.579,32,32,1.000,9,102,111,127,32,15,31,101,474
2020,Omari Spellman,C,22,GSW,49,3,886,127,295,.431,43,110,.391,84,185,.454,.503,73,92,.793,77,142,219,47,33,24,54,63,370
2020,Max Strus,SF,23,CHI,2,0,6,2,3,.667,0,1,.000,2,2,1.000,.667,1,1,1.000,1,0,1,0,0,0,0,1,5
2020,Edmond Sumner,SG,24,IND,31,3,447,61,142,.430,14,53,.264,47,89,.528,.479,16,29,.552,11,35,46,55,15,9,22,44,152
2020,Caleb Swanigan,PF-C,22,TOT,27,1,288,28,47,.596,0,2,.000,28,45,.622,.596,9,17,.529,27,73,100,31,3,7,37,62,65
2020,Jayson Tatum,PF,21,BOS,66,66,2265,552,1226,.450,189,469,.403,363,757,.480,.527,254,313,.812,64,396,460,200,93,57,155,136,1547
2020,Jeff Teague,PG,31,TOT,59,17,1464,213,489,.436,43,117,.368,170,372,.457,.480,172,197,.873,27,115,142,308,44,19,116,106,641
2020,Garrett Temple,SG,33,BRK,62,35,1730,222,587,.378,127,386,.329,95,201,.473,.486,70,87,.805,29,189,218,156,49,29,62,108,641
2020,Daniel Theis,C,27,BOS,65,64,1566,241,426,.566,32,96,.333,209,330,.633,.603,87,114,.763,140,286,426,111,37,84,54,219,601
2020,Isaiah Thomas,PG,30,WAS,40,37,925,174,426,.408,78,189,.413,96,237,.405,.500,62,76,.816,11,57,68,146,13,6,77,77,488
2020,Khyri Thomas,SG,23,DET,8,0,61,5,17,.294,5,14,.357,0,3,.000,.441,2,4,.500,1,0,1,3,3,0,3,9,17
2020,Lance Thomas,PF,31,BRK,7,4,98,8,23,.348,4,13,.308,4,10,.400,.435,4,4,1.000,2,11,13,6,0,0,6,11,24
2020,Matt Thomas,SG,25,TOR,41,1,440,73,150,.487,47,99,.475,26,51,.510,.643,9,12,.750,9,52,61,22,10,1,16,38,202
2020,Tristan Thompson,PF,28,CLE,57,51,1721,288,562,.512,9,23,.391,279,539,.518,.520,99,161,.615,226,351,577,120,33,50,103,124,684
2020,Sindarius Thornwell,SF,25,NOP,2,0,35,6,11,.545,2,4,.500,4,7,.571,.636,2,4,.500,0,4,4,4,1,1,2,2,16
2020,Matisse Thybulle,SG,22,PHI,65,14,1287,112,265,.423,56,157,.357,56,108,.519,.528,25,41,.610,44,63,107,79,94,47,51,141,305
2020,Anthony Tolliver,PF,34,TOT,55,13,872,65,182,.357,49,145,.338,16,37,.432,.492,21,29,.724,34,120,154,42,19,11,34,74,200
2020,Juan Toscano-Anderson,SG,26,GSW,13,6,272,29,63,.460,8,23,.348,21,40,.525,.524,3,5,.600,9,43,52,26,13,5,16,30,69
2020,Karl-Anthony Towns,C,24,MIN,35,35,1187,316,622,.508,114,277,.412,202,345,.586,.600,180,226,.796,95,283,378,153,33,42,110,117,926
2020,Gary Trent Jr.,SF,21,POR,61,8,1332,196,441,.444,112,268,.418,84,173,.486,.571,37,45,.822,25,75,100,61,48,16,21,90,541
2020,Allonzo Trier,SG,24,NYK,24,1,291,51,106,.481,19,53,.358,32,53,.604,.571,34,43,.791,6,23,29,28,3,4,22,29,155
2020,P.J. Tucker,PF,34,HOU,72,72,2467,177,426,.415,107,299,.358,70,127,.551,.541,39,48,.813,112,364,476,115,77,36,72,229,500
2020,Rayjon Tucker,SG,22,UTA,20,0,161,20,43,.465,3,17,.176,17,26,.654,.500,19,23,.826,3,17,20,5,1,1,8,10,62
2020,Evan Turner,SG,31,ATL,19,0,251,25,67,.373,0,5,.000,25,62,.403,.373,12,14,.857,8,30,38,38,9,8,26,20,62
2020,Myles Turner,C,23,IND,62,62,1826,268,587,.457,86,250,.344,182,337,.540,.530,127,169,.751,86,321,407,72,46,132,85,166,749
2020,Jarrod Uthoff,PF,26,TOT,7,0,53,7,18,.389,3,9,.333,4,9,.444,.472,2,2,1.000,2,4,6,0,1,0,0,2,19
2020,Jonas Valančiūnas,C,27,MEM,70,70,1845,432,739,.585,32,91,.352,400,648,.617,.606,148,200,.740,213,575,788,131,30,76,127,185,1044
2020,Denzel Valentine,SF,26,CHI,36,5,488,97,237,.409,46,137,.336,51,100,.510,.506,6,8,.750,9,65,74,43,26,6,26,51,246
2020,Jarred Vanderbilt,PF,20,TOT,11,0,46,5,8,.625,0,1,.000,5,7,.714,.625,2,2,1.000,3,6,9,2,3,1,7,6,12
2020,Fred VanVleet,SG,25,TOR,54,54,1928,319,773,.413,146,374,.390,173,399,.434,.507,168,198,.848,18,185,203,357,100,17,121,132,952
2020,Gabe Vincent,PG,23,MIA,9,0,83,8,37,.216,6,27,.222,2,10,.200,.297,0,0,,0,5,5,6,5,0,1,6,22
2020,Noah Vonleh,C,24,TOT,36,1,377,52,92,.565,3,15,.200,49,77,.636,.582,25,32,.781,37,87,124,28,11,6,21,40,132
2020,Nikola Vučević,C,29,ORL,62,62,1998,493,1033,.477,98,289,.339,395,744,.531,.525,131,167,.784,140,533,673,222,54,47,88,135,1215
2020,Dean Wade,PF,23,CLE,12,0,71,9,13,.692,2,4,.500,7,9,.778,.769,0,1,.000,3,16,19,2,2,4,3,8,20
2020,Moritz Wagner,C,22,WAS,45,5,835,145,266,.545,25,80,.313,120,186,.645,.592,78,95,.821,56,163,219,56,28,19,66,152,393
2020,Dion Waiters,SG,28,TOT,10,0,207,41,99,.414,15,47,.319,26,52,.500,.490,14,17,.824,2,22,24,20,4,6,16,21,111
2020,Kemba Walker,PG,29,BOS,56,56,1742,378,889,.425,180,473,.381,198,416,.476,.526,209,242,.864,36,181,217,268,48,28,117,91,1145
2020,Lonnie Walker IV,SG,21,SAS,61,12,988,152,357,.426,41,101,.406,111,256,.434,.483,44,61,.721,23,116,139,68,32,14,44,78,389
2020,Tyrone Wallace,SG,25,ATL,14,0,160,14,44,.318,1,15,.067,13,29,.448,.330,11,17,.647,3,19,22,13,7,1,10,19,40
2020,Derrick Walton,PG,24,TOT,26,1,248,18,39,.462,10,24,.417,8,15,.533,.590,7,9,.778,2,14,16,27,7,0,5,21,53
2020,Brad Wanamaker,PG,30,BOS,71,1,1369,162,362,.448,37,102,.363,125,260,.481,.499,126,136,.926,22,122,144,179,61,14,76,133,487
2020,T.J. Warren,SF,26,IND,67,67,2202,534,997,.536,91,226,.403,443,771,.575,.581,167,204,.819,68,212,280,99,78,34,84,187,1326
2020,P.J. Washington,PF,21,CHO,58,57,1759,268,589,.455,86,230,.374,182,359,.507,.528,88,136,.647,58,258,316,123,51,44,93,158,710
2020,Yuta Watanabe,SF,25,MEM,18,0,105,15,34,.441,3,8,.375,12,26,.462,.485,3,8,.375,7,13,20,5,5,1,2,9,36
2020,Tremont Waters,PG,22,BOS,11,1,119,14,49,.286,4,24,.167,10,25,.400,.327,8,8,1.000,0,12,12,16,10,2,15,13,40
2020,Paul Watson,SF,25,TOT,10,0,87,10,26,.385,4,12,.333,6,14,.429,.462,7,9,.778,2,15,17,8,4,1,3,5,31
2020,Quinndary Weatherspoon,SG,23,SAS,11,0,78,5,17,.294,1,5,.200,4,12,.333,.324,1,2,.500,1,6,7,11,3,1,5,8,12
2020,Russell Westbrook,PG,31,HOU,57,57,2049,604,1281,.472,55,213,.258,549,1068,.514,.493,290,380,.763,100,351,451,401,93,20,255,200,1553
2020,Coby White,PG,19,CHI,65,1,1674,312,792,.394,133,376,.354,179,416,.430,.478,102,129,.791,28,202,230,175,49,6,109,117,859
2020,Derrick White,SG,25,SAS,68,20,1677,253,552,.458,79,216,.366,174,336,.518,.530,180,211,.853,35,188,223,241,44,59,89,152,765
2020,Hassan Whiteside,C,30,POR,67,61,2008,436,702,.621,4,7,.571,432,695,.622,.624,164,239,.686,258,647,905,78,26,196,120,196,1040
2020,Andrew Wiggins,SF,24,TOT,54,54,1858,437,978,.447,111,334,.332,326,644,.506,.504,190,268,.709,66,208,274,198,45,53,132,127,1175
2020,Grant Williams,PF,21,BOS,69,5,1043,87,211,.412,24,96,.250,63,115,.548,.469,39,54,.722,59,119,178,68,30,36,50,163,237
2020,Johnathan Williams,PF,24,WAS,15,6,180,19,34,.559,0,2,.000,19,32,.594,.559,7,13,.538,24,40,64,8,1,8,5,16,45
2020,Kenrich Williams,PF,25,NOP,39,18,832,51,147,.347,25,97,.258,26,50,.520,.432,9,26,.346,51,135,186,57,27,21,22,88,136
2020,Lou Williams,PG,33,LAC,65,8,1864,391,936,.418,111,315,.352,280,621,.451,.477,292,339,.861,31,170,201,365,43,12,182,80,1185
2020,Marvin Williams,PF,33,TOT,58,1,1129,119,267,.446,56,156,.359,63,111,.568,.551,49,57,.860,30,153,183,60,36,30,33,103,343
2020,Robert Williams,C,22,BOS,29,1,388,64,88,.727,0,0,,64,88,.727,.727,22,34,.647,40,88,128,27,22,35,21,51,150
2020,Nigel Williams-Goss,PG,25,UTA,10,0,50,5,16,.313,2,7,.286,3,9,.333,.375,2,2,1.000,2,4,6,6,3,1,3,6,14
2020,Zion Williamson,PF,19,NOP,24,24,668,210,360,.583,6,14,.429,204,346,.590,.592,114,178,.640,64,86,150,50,16,9,59,42,540
2020,D.J. Wilson,PF,23,MIL,37,1,363,52,132,.394,18,73,.247,34,59,.576,.462,11,18,.611,12,80,92,25,3,5,19,33,133
2020,Justise Winslow,SG,23,MIA,11,5,352,50,129,.388,6,27,.222,44,102,.431,.411,18,27,.667,16,57,73,44,7,5,24,38,124
2020,Christian Wood,PF,24,DET,62,12,1325,288,508,.567,54,140,.386,234,368,.636,.620,180,242,.744,104,286,390,60,34,54,84,98,810
2020,Delon Wright,PG,27,DAL,73,5,1570,190,411,.462,47,127,.370,143,284,.504,.519,77,100,.770,70,210,280,244,85,22,73,93,504
2020,Justin Wright-Foreman,PG,22,UTA,4,0,45,7,20,.350,2,10,.200,5,10,.500,.400,3,4,.750,0,5,5,7,2,0,3,5,19
2020,Thaddeus Young,PF,31,CHI,64,16,1591,269,601,.448,79,222,.356,190,379,.501,.513,42,72,.583,94,221,315,117,92,23,102,134,659
2020,Trae Young,PG,21,ATL,60,60,2120,546,1249,.437,205,568,.361,341,681,.501,.519,481,559,.860,32,223,255,560,65,8,289,104,1778
2020,Cody Zeller,C,27,CHO,58,39,1341,251,479,.524,18,75,.240,233,404,.577,.543,122,179,.682,160,251,411,88,40,25,75,140,642
2020,Tyler Zeller,C,30,SAS,2,0,4,1,4,.250,0,0,,1,4,.250,.250,0,0,,3,1,4,0,0,0,0,0,2
2020,Ante Žižić,C,23,CLE,22,0,221,41,72,.569,0,0,,41,72,.569,.569,14,19,.737,18,48,66,6,7,5,10,27,96
2020,Ivica Zubac,C,22,LAC,72,70,1326,236,385,.613,0,2,.000,236,383,.616,.613,124,166,.747,197,346,543,82,16,66,61,168,596
2021,Precious Achiuwa,PF,21,MIA,61,4,737,124,228,.544,0,1,.000,124,227,.546,.544,56,110,.509,73,135,208,29,20,28,43,91,304
2021,Jaylen Adams,PG,24,MIL,7,0,18,1,8,.125,0,2,.000,1,6,.167,.125,0,0,,0,3,3,2,0,0,0,1,2
2021,Steven Adams,C,27,NOP,58,58,1605,189,308,.614,0,3,.000,189,305,.620,.614,60,135,.444,213,301,514,111,54,38,78,113,438
2021,Bam Adebayo,C,23,MIA,64,64,2143,456,800,.570,2,8,.250,454,792,.573,.571,283,354,.799,142,431,573,346,75,66,169,145,1197
2021,LaMarcus Aldridge,C,35,TOT,26,23,674,140,296,.473,31,80,.388,109,216,.505,.525,41,47,.872,19,99,118,49,11,29,27,47,352
2021,Ty-Shon Alexander,SG,22,PHO,15,0,47,3,12,.250,2,9,.222,1,3,.333,.333,1,2,.500,2,8,10,6,0,1,3,2,9
2021,Nickeil Alexander-Walker,SG,22,NOP,46,13,1007,192,458,.419,76,219,.347,116,239,.485,.502,48,66,.727,13,131,144,102,47,22,69,88,508
2021,Grayson Allen,SG,25,MEM,50,38,1259,173,414,.418,107,274,.391,66,140,.471,.547,79,91,.868,19,141,160,108,46,8,48,71,532
2021,Jarrett Allen,C,22,TOT,63,45,1864,298,482,.618,6,19,.316,292,463,.631,.624,204,290,.703,196,435,631,106,32,90,100,96,806
2021,Al-Farouq Aminu,PF,30,TOT,23,14,434,38,99,.384,8,37,.216,30,62,.484,.424,18,22,.818,22,88,110,31,19,9,28,29,102
2021,Kyle Anderson,PF,27,MEM,69,69,1887,308,658,.468,94,261,.360,214,397,.539,.540,144,184,.783,52,344,396,250,84,57,86,120,854
2021,Giannis Antetokounmpo,PF,26,MIL,61,61,2013,626,1100,.569,67,221,.303,559,879,.636,.600,398,581,.685,97,574,671,357,72,73,207,168,1717
2021,Kostas Antetokounmpo,PF,23,LAL,15,0,56,3,10,.300,0,0,,3,10,.300,.300,6,13,.462,4,15,19,1,2,4,11,8,12
2021,Thanasis Antetokounmpo,SF,28,MIL,57,3,551,67,137,.489,7,29,.241,60,108,.556,.515,25,49,.510,54,70,124,46,22,10,43,74,166
2021,Carmelo Anthony,PF,36,POR,69,3,1690,327,777,.421,133,325,.409,194,452,.429,.506,137,154,.890,32,182,214,104,46,38,61,144,924
2021,Cole Anthony,PG,20,ORL,47,34,1273,219,552,.397,58,172,.337,161,380,.424,.449,109,131,.832,38,183,221,192,30,18,106,98,605
2021,OG Anunoby,SF,23,TOR,43,43,1433,249,519,.480,104,261,.398,145,258,.562,.580,80,102,.784,54,183,237,94,66,32,75,114,682
2021,Ryan Arcidiacono,PG,26,CHI,44,0,450,49,117,.419,25,67,.373,24,50,.480,.526,13,20,.650,5,62,67,56,9,0,10,47,136
2021,Trevor Ariza,SF,35,MIA,30,27,841,99,241,.411,50,143,.350,49,98,.500,.515,34,44,.773,27,117,144,55,31,18,21,55,282
2021,D.J. Augustin,PG,33,TOT,57,12,1129,135,343,.394,83,217,.382,52,126,.413,.515,85,94,.904,20,74,94,188,28,1,65,56,438
2021,Deni Avdija,SF,20,WAS,54,32,1257,130,312,.417,53,168,.315,77,144,.535,.502,29,45,.644,22,240,262,63,32,15,33,140,342
2021,Deandre Ayton,C,22,PHO,69,69,2115,430,687,.626,4,20,.200,426,667,.639,.629,133,173,.769,228,499,727,99,41,81,103,196,997
2021,Udoka Azubuike,C,21,UTA,15,0,57,4,9,.444,0,0,,4,9,.444,.444,8,10,.800,4,9,13,0,1,4,3,9,16
2021,Dwayne Bacon,SG,25,ORL,72,50,1853,292,726,.402,59,207,.285,233,519,.449,.443,145,176,.824,31,193,224,93,45,5,46,103,788
2021,Marvin Bagley III,PF,21,SAC,43,42,1112,247,490,.504,37,108,.343,210,382,.550,.542,77,134,.575,106,212,318,43,21,21,59,100,608
2021,LaMelo Ball,PG,19,CHO,51,31,1469,293,672,.436,92,261,.352,201,411,.489,.504,125,165,.758,63,239,302,313,81,18,145,136,803
2021,Lonzo Ball,PG,23,NOP,55,55,1747,290,700,.414,172,455,.378,118,245,.482,.537,50,64,.781,33,230,263,316,82,31,123,103,802
2021,Mo Bamba,C,22,ORL,46,5,725,142,301,.472,38,118,.322,104,183,.568,.535,45,66,.682,76,189,265,35,14,58,36,87,367
2021,Desmond Bane,SG,22,MEM,68,17,1519,234,499,.469,117,271,.432,117,228,.513,.586,40,49,.816,31,179,210,118,41,16,59,125,625
2021,Harrison Barnes,PF,28,SAC,58,58,2102,319,642,.497,100,256,.391,219,386,.567,.575,195,235,.830,64,321,385,201,43,11,93,75,933
2021,RJ Barrett,SG,20,NYK,72,72,2511,467,1060,.441,124,309,.401,343,751,.457,.499,206,276,.746,68,346,414,217,53,20,139,188,1264
2021,Will Barton,SF,30,DEN,56,52,1736,259,608,.426,98,257,.381,161,351,.459,.507,95,121,.785,39,187,226,181,50,23,96,95,711
2021,Keita Bates-Diop,SF,25,SAS,30,0,245,30,67,.448,5,17,.294,25,50,.500,.485,14,21,.667,9,40,49,12,11,5,7,11,79
2021,Nicolas Batum,SF,32,LAC,67,38,1835,191,412,.464,110,272,.404,81,140,.579,.597,48,58,.828,50,266,316,148,69,37,53,102,540
2021,Aron Baynes,C,34,TOR,53,31,980,134,304,.441,27,103,.262,107,201,.532,.485,29,41,.707,87,186,273,47,17,23,46,119,324
2021,Kent Bazemore,SF,31,GSW,67,18,1333,176,392,.449,75,184,.408,101,208,.486,.545,54,78,.692,26,203,229,108,69,33,82,158,481
2021,Darius Bazley,PF,20,OKC,55,55,1714,273,690,.396,83,286,.290,190,404,.470,.456,125,178,.702,51,345,396,99,29,25,122,60,754
2021,Bradley Beal,SG,27,WAS,60,60,2147,670,1382,.485,130,373,.349,540,1009,.535,.532,408,459,.889,72,211,283,265,69,22,187,140,1878
2021,Malik Beasley,SG,24,MIN,37,36,1214,264,600,.440,128,321,.399,136,279,.487,.547,68,80,.850,28,134,162,88,30,7,60,62,724
2021,Jordan Bell,C,26,TOT,6,1,82,7,22,.318,0,2,.000,7,20,.350,.318,1,2,.500,7,17,24,7,3,5,4,7,15
2021,DeAndre' Bembry,SF,26,TOR,51,12,972,117,228,.513,14,53,.264,103,175,.589,.544,45,66,.682,33,113,146,107,53,18,71,87,293
2021,Dāvis Bertāns,PF,28,WAS,57,7,1464,193,478,.404,169,428,.395,24,50,.480,.581,100,115,.870,18,150,168,49,33,13,33,136,655
2021,Patrick Beverley,PG,32,LAC,37,34,832,93,220,.423,56,141,.397,37,79,.468,.550,36,45,.800,29,90,119,76,29,28,34,108,278
2021,Saddiq Bey,SF,21,DET,70,53,1909,279,691,.404,175,460,.380,104,231,.450,.530,124,147,.844,43,275,318,95,52,14,60,110,857
2021,Tyler Bey,SF,22,DAL,18,0,71,7,22,.318,1,4,.250,6,18,.333,.341,3,5,.600,8,11,19,3,0,1,3,6,18
2021,Khem Birch,C,28,TOT,67,22,1529,189,380,.497,13,52,.250,176,328,.537,.514,91,129,.705,174,213,387,89,48,50,44,113,482
2021,Goga Bitadze,C,21,IND,45,3,561,83,194,.428,20,79,.253,63,115,.548,.479,45,61,.738,60,90,150,37,9,60,17,94,231
2021,Bismack Biyombo,C,28,CHO,66,36,1349,142,242,.587,0,1,.000,142,241,.589,.587,47,105,.448,137,210,347,81,17,74,71,141,331
2021,Nemanja Bjelica,PF,32,TOT,37,3,595,89,196,.454,27,85,.318,62,111,.559,.523,37,51,.725,29,98,127,69,15,5,33,68,242
2021,Eric Bledsoe,SG,31,NOP,71,70,2111,307,730,.421,121,355,.341,186,375,.496,.503,134,195,.687,29,215,244,268,55,24,114,112,869
2021,Keljin Blevins,SF,25,POR,17,0,75,5,20,.250,2,8,.250,3,12,.250,.300,0,0,,3,7,10,4,2,0,5,8,12
2021,Bogdan Bogdanović,SG,28,ATL,44,27,1305,267,565,.473,146,333,.438,121,232,.522,.602,40,44,.909,20,140,160,147,49,13,54,99,720
2021,Bojan Bogdanović,SF,31,UTA,72,72,2216,406,925,.439,180,461,.390,226,464,.487,.536,233,265,.879,40,241,281,136,45,4,128,115,1225
2021,Bol Bol,PF,21,DEN,32,2,160,25,58,.431,9,24,.375,16,34,.471,.509,10,15,.667,0,24,24,7,3,10,13,14,69
2021,Marques Bolden,C,22,CLE,6,0,29,1,3,.333,0,0,,1,3,.333,.333,5,8,.625,3,3,6,0,2,2,2,0,7
2021,Jordan Bone,PG,23,ORL,14,0,196,23,54,.426,10,32,.313,13,22,.591,.519,0,0,,4,20,24,18,2,0,3,11,56
2021,Isaac Bonga,SF,21,WAS,40,8,432,30,81,.370,13,47,.277,17,34,.500,.451,5,8,.625,18,48,66,23,11,9,22,63,78
2021,Devin Booker,SG,24,PHO,67,67,2270,623,1287,.484,126,371,.340,497,916,.543,.533,340,392,.867,34,247,281,289,53,16,207,181,1712
2021,Chris Boucher,C,28,TOR,60,14,1453,288,560,.514,90,235,.383,198,325,.609,.595,152,193,.788,117,287,404,63,35,111,46,166,818
2021,Brian Bowen,SF,22,IND,6,0,15,1,4,.250,0,1,.000,1,3,.333,.250,1,1,1.000,0,3,3,0,0,0,0,1,3
2021,Avery Bradley,SG,30,TOT,27,6,602,64,171,.374,33,101,.327,31,70,.443,.471,12,15,.800,8,49,57,46,21,3,28,55,173
2021,Tony Bradley,C,23,TOT,42,8,684,131,197,.665,0,3,.000,131,194,.675,.665,38,55,.691,85,154,239,37,15,30,33,61,300
2021,Jarrell Brantley,PF,24,UTA,28,0,138,25,52,.481,12,28,.429,13,24,.542,.596,2,2,1.000,9,18,27,15,7,2,8,17,64
2021,Ignas Brazdeikis,SF,22,TOT,13,0,249,35,83,.422,11,28,.393,24,55,.436,.488,10,14,.714,11,34,45,17,4,3,12,22,91
2021,Mikal Bridges,SF,24,PHO,72,72,2348,363,669,.543,134,315,.425,229,354,.647,.643,110,131,.840,76,233,309,152,76,63,57,116,970
2021,Miles Bridges,PF,22,CHO,66,19,1932,313,622,.503,116,290,.400,197,332,.593,.596,98,113,.867,81,316,397,147,44,52,106,143,840
2021,Amida Brimah,C,26,IND,5,0,29,5,8,.625,0,0,,5,8,.625,.625,3,3,1.000,2,6,8,1,0,5,4,4,13
2021,Oshae Brissett,SF,22,IND,21,16,519,73,151,.483,33,78,.423,40,73,.548,.593,50,65,.769,29,86,115,18,19,20,10,32,229
2021,Malcolm Brogdon,PG,28,IND,56,56,1930,444,980,.453,145,374,.388,299,606,.493,.527,153,177,.864,58,236,294,329,49,15,115,110,1186
2021,Armoni Brooks,SG,22,HOU,20,5,520,78,192,.406,60,157,.382,18,35,.514,.563,7,12,.583,10,58,68,30,12,5,22,34,223
2021,Dillon Brooks,SF,25,MEM,67,67,1997,432,1031,.419,128,372,.344,304,659,.461,.481,159,195,.815,53,143,196,157,78,26,119,237,1151
2021,Bruce Brown,PG,24,BRK,65,37,1451,235,423,.556,17,59,.288,218,364,.599,.576,86,117,.735,111,238,349,104,58,28,54,145,573
2021,Charlie Brown Jr.,SG,23,OKC,9,1,152,13,43,.302,5,21,.238,8,22,.364,.360,9,10,.900,3,14,17,9,4,2,6,19,40
2021,Jaylen Brown,SG,24,BOS,58,58,1999,538,1111,.484,163,411,.397,375,700,.536,.558,191,250,.764,71,276,347,195,72,32,158,168,1430
2021,Moses Brown,C,21,OKC,43,32,920,146,268,.545,0,0,,146,268,.545,.545,78,126,.619,154,229,383,10,31,47,43,93,370
2021,Sterling Brown,SG,25,HOU,51,14,1229,150,335,.448,91,215,.423,59,120,.492,.584,25,31,.806,38,186,224,72,38,12,41,97,416
2021,Troy Brown Jr.,SF,21,TOT,34,0,524,62,144,.431,22,70,.314,40,74,.541,.507,15,21,.714,20,85,105,29,10,6,21,49,161
2021,Jalen Brunson,PG,24,DAL,68,12,1697,328,627,.523,81,200,.405,247,427,.578,.588,120,151,.795,27,204,231,239,35,1,80,109,857
2021,Elijah Bryant,SG,25,MIL,1,0,32,6,13,.462,1,5,.200,5,8,.625,.500,3,3,1.000,2,4,6,3,0,1,4,4,16
2021,Thomas Bryant,C,23,WAS,10,10,271,59,91,.648,9,21,.429,50,70,.714,.698,16,24,.667,18,43,61,15,4,8,11,31,143
2021,Reggie Bullock,SF,29,NYK,65,64,1949,248,561,.442,163,398,.410,85,163,.521,.587,50,55,.909,16,207,223,99,52,11,45,146,709
2021,Trey Burke,PG,28,DAL,62,1,911,151,353,.428,58,164,.354,93,189,.492,.510,51,57,.895,10,44,54,81,36,7,33,64,411
2021,Alec Burks,SG,29,NYK,49,5,1255,210,500,.420,102,246,.415,108,254,.425,.522,101,118,.856,21,206,227,107,31,14,49,102,623
2021,Jimmy Butler,SF,31,MIA,52,52,1745,366,736,.497,25,102,.245,341,634,.538,.514,359,416,.863,94,265,359,369,108,18,109,71,1116
2021,Bruno Caboclo,PF,25,HOU,6,0,36,8,17,.471,0,5,.000,8,12,.667,.471,1,2,.500,3,11,14,1,0,2,4,6,17
2021,Devontae Cacok,PF,24,LAL,20,1,98,17,29,.586,0,0,,17,29,.586,.586,5,11,.455,12,20,32,1,5,4,5,8,39
2021,Kentavious Caldwell-Pope,SG,27,LAL,67,67,1902,218,506,.431,120,293,.410,98,213,.460,.549,97,112,.866,27,152,179,127,62,26,66,114,653
2021,Facundo Campazzo,PG,29,DEN,65,19,1425,120,315,.381,76,216,.352,44,99,.444,.502,80,91,.879,22,112,134,232,79,14,73,132,396
2021,Vlatko Čančar,PF,23,DEN,41,1,281,33,72,.458,9,33,.273,24,39,.615,.521,10,13,.769,11,39,50,14,11,2,14,18,85
2021,Devin Cannady,PG,24,ORL,8,0,74,11,28,.393,6,16,.375,5,12,.417,.500,6,7,.857,0,5,5,1,5,1,2,9,34
2021,Clint Capela,C,26,ATL,63,63,1898,413,695,.594,0,0,,413,695,.594,.594,130,227,.573,297,606,903,49,44,129,73,145,956
2021,Vernon Carey Jr.,C,19,CHO,19,4,115,18,36,.500,1,7,.143,17,29,.586,.514,9,11,.818,6,21,27,2,1,5,5,13,46
2021,Jevon Carter,PG,25,PHO,60,1,717,94,223,.422,56,151,.371,38,72,.528,.547,4,7,.571,16,76,92,71,29,9,16,56,248
2021,Wendell Carter Jr.,C,21,TOT,54,44,1375,230,457,.503,15,51,.294,215,406,.530,.520,131,179,.732,132,311,443,104,35,42,78,146,606
2021,Michael Carter-Williams,SG,29,ORL,31,25,800,105,270,.389,15,61,.246,90,209,.431,.417,49,80,.613,39,100,139,129,25,17,69,81,274
2021,Alex Caruso,PG,26,LAL,58,6,1216,133,305,.436,55,137,.401,78,168,.464,.526,49,76,.645,31,139,170,160,64,15,76,108,370
2021,Willie Cauley-Stein,C,27,DAL,53,16,906,115,182,.632,1,11,.091,114,171,.667,.635,49,78,.628,66,170,236,35,21,43,29,129,280
2021,Chris Chiozza,PG,25,BRK,22,1,232,31,88,.352,13,42,.310,18,46,.391,.426,13,17,.765,3,21,24,65,7,6,16,19,88
2021,Marquese Chriss,PF,23,GSW,2,0,27,5,14,.357,1,5,.200,4,9,.444,.393,2,4,.500,3,10,13,2,0,2,2,3,13
2021,Gary Clark,PF-SF,26,TOT,39,11,654,40,132,.303,31,108,.287,9,24,.375,.420,8,10,.800,33,82,115,31,13,7,17,35,119
2021,Brandon Clarke,PF,24,MEM,59,16,1415,256,495,.517,20,77,.260,236,418,.565,.537,78,113,.690,97,231,328,95,60,51,33,84,610
2021,Jordan Clarkson,SG,28,UTA,68,1,1818,457,1075,.425,208,599,.347,249,476,.523,.522,129,144,.896,47,227,274,168,61,10,115,110,1251
2021,Nic Claxton,C,21,BRK,32,1,594,90,145,.621,1,5,.200,89,140,.636,.624,31,64,.484,43,123,166,28,23,40,18,68,212
2021,Amir Coffey,SG,23,LAC,44,1,394,45,103,.437,23,56,.411,22,47,.468,.549,27,38,.711,10,34,44,22,10,0,15,30,140
2021,John Collins,PF,23,ATL,63,63,1848,429,771,.556,83,208,.399,346,563,.615,.610,170,204,.833,118,349,467,78,34,63,84,193,1111
2021,Mike Conley,PG,33,UTA,51,51,1498,284,640,.444,138,335,.412,146,305,.479,.552,121,142,.852,36,141,177,305,70,9,99,98,827
2021,Pat Connaughton,SG,28,MIL,69,4,1575,168,387,.434,101,272,.371,67,115,.583,.565,31,40,.775,63,269,332,81,49,23,33,99,468
2021,Quinn Cook,PG,27,TOT,23,0,157,29,68,.426,11,26,.423,18,42,.429,.507,7,8,.875,2,15,17,18,4,1,7,10,76
2021,Tyler Cook,SF-PF,23,TOT,32,1,438,69,103,.670,1,2,.500,68,101,.673,.675,17,35,.486,28,67,95,17,8,2,21,35,156
2021,DeMarcus Cousins,C,30,TOT,41,11,713,130,305,.426,47,135,.348,83,170,.488,.503,59,81,.728,53,210,263,76,34,24,64,107,366
2021,Robert Covington,PF,30,POR,70,70,2243,204,509,.401,135,356,.379,69,153,.451,.533,50,62,.806,61,405,466,117,101,84,64,195,593
2021,Torrey Craig,SF,30,TOT,50,8,803,109,227,.480,39,106,.368,70,121,.579,.566,17,22,.773,57,140,197,49,28,26,25,83,274
2021,Jae Crowder,PF,30,PHO,60,42,1648,199,492,.404,148,380,.389,51,112,.455,.555,57,75,.760,32,250,282,127,48,27,55,125,603
2021,Jarrett Culver,SG,21,MIN,34,7,499,69,168,.411,13,53,.245,56,115,.487,.449,29,48,.604,34,70,104,24,17,9,28,58,180
2021,Seth Curry,SG,30,PHI,57,57,1638,258,552,.467,126,280,.450,132,272,.485,.582,69,77,.896,10,126,136,155,44,8,65,96,711
2021,Stephen Curry,PG,32,GSW,63,63,2152,658,1365,.482,337,801,.421,321,564,.569,.605,362,395,.916,29,316,345,363,77,8,213,119,2015
2021,Nate Darling,SG,22,CHO,7,0,26,2,7,.286,2,7,.286,0,0,,.429,3,3,1.000,1,0,1,1,0,1,1,1,9
2021,Anthony Davis,PF,27,LAL,36,36,1162,301,613,.491,26,100,.260,275,513,.536,.512,158,214,.738,62,224,286,110,45,59,74,60,786
2021,Ed Davis,C,31,MIN,23,7,299,19,44,.432,0,0,,19,44,.432,.432,10,12,.833,46,69,115,21,13,13,7,56,48
2021,Terence Davis,SG,23,TOT,61,4,1074,195,456,.428,98,267,.367,97,189,.513,.535,45,55,.818,20,134,154,83,44,14,63,97,533
2021,Gabriel Deck,PF,25,OKC,10,0,212,32,67,.478,2,15,.133,30,52,.577,.493,18,22,.818,16,24,40,24,8,0,6,9,84
2021,Dewayne Dedmon,C,31,MIA,16,0,210,46,65,.708,1,5,.200,45,60,.750,.715,20,27,.741,28,58,86,12,9,6,13,36,113
2021,Matthew Dellavedova,PG,30,CLE,13,1,224,14,56,.250,4,25,.160,10,31,.323,.286,4,4,1.000,6,18,24,58,4,1,6,21,36
2021,DeMar DeRozan,PF,31,SAS,61,61,2056,455,920,.495,19,74,.257,436,846,.515,.505,387,440,.880,40,219,259,422,56,15,119,128,1316
2021,Mamadi Diakite,PF,24,MIL,14,1,141,16,40,.400,1,8,.125,15,32,.469,.413,11,14,.786,8,26,34,8,7,6,3,16,44
2021,Hamidou Diallo,SG-SF,22,TOT,52,9,1226,224,470,.477,28,82,.341,196,388,.505,.506,128,200,.640,59,213,272,101,41,24,76,134,604
2021,Gorgui Dieng,C,31,TOT,38,1,552,85,163,.521,30,70,.429,55,93,.591,.613,58,67,.866,40,100,140,48,26,16,32,56,258
2021,Spencer Dinwiddie,SG,27,BRK,3,3,64,6,16,.375,2,7,.286,4,9,.444,.438,6,6,1.000,0,13,13,9,2,1,5,4,20
2021,Donte DiVincenzo,SG,24,MIL,66,66,1814,253,603,.420,131,346,.379,122,257,.475,.528,51,71,.718,81,299,380,203,72,15,91,112,688
2021,Luka Dončić,PG,21,DAL,66,66,2262,647,1351,.479,192,548,.350,455,803,.567,.550,344,471,.730,54,473,527,567,64,36,281,152,1830
2021,Luguentz Dort,SG,21,OKC,52,52,1543,247,639,.387,113,329,.343,134,310,.432,.475,122,164,.744,38,151,189,88,45,19,79,134,729
2021,Damyean Dotson,SG,26,CLE,46,7,907,119,293,.406,46,159,.289,73,134,.545,.485,24,36,.667,5,88,93,91,16,4,42,42,308
2021,Devon Dotson,PG,21,CHI,11,0,50,11,21,.524,1,7,.143,10,14,.714,.548,0,0,,2,3,5,7,4,0,0,3,23
2021,Sekou Doumbouya,PF,20,DET,56,11,869,107,282,.379,26,115,.226,81,167,.485,.426,45,64,.703,39,104,143,47,24,9,44,94,285
2021,PJ Dozier,SG,24,DEN,50,6,1088,148,355,.417,47,149,.315,101,206,.490,.483,42,66,.636,35,147,182,92,31,22,46,86,385
2021,Goran Dragić,PG,34,MIA,50,11,1337,240,555,.432,91,244,.373,149,311,.479,.514,101,122,.828,25,144,169,219,33,8,118,113,672
2021,Andre Drummond,C,27,TOT,46,46,1242,282,572,.493,0,8,.000,282,564,.500,.493,123,205,.600,166,385,551,94,63,49,124,149,687
2021,Jared Dudley,PF,35,LAL,12,0,81,2,9,.222,2,6,.333,0,3,.000,.333,0,0,,4,17,21,5,1,1,2,7,6
2021,Kris Dunn,PG,26,ATL,4,0,45,1,12,.083,0,2,.000,1,10,.100,.083,3,4,.750,0,6,6,2,2,2,3,10,5
2021,Kevin Durant,PF,32,BRK,35,32,1157,324,603,.537,85,189,.450,239,414,.577,.608,210,238,.882,13,234,247,195,25,45,120,70,943
2021,Anthony Edwards,SG,19,MIN,72,55,2314,505,1211,.417,171,520,.329,334,691,.483,.488,211,272,.776,59,277,336,211,82,36,160,129,1392
2021,Carsen Edwards,SG,22,BOS,31,1,276,47,111,.423,18,63,.286,29,48,.604,.505,11,13,.846,3,23,26,14,7,1,7,25,123
2021,CJ Elleby,SF,20,POR,30,0,192,25,66,.379,7,34,.206,18,32,.563,.432,11,15,.733,11,21,32,10,6,3,5,27,68
2021,Henry Ellenson,PF,24,TOR,2,0,38,5,14,.357,2,9,.222,3,5,.600,.429,3,4,.750,3,9,12,5,0,0,0,7,15
2021,Wayne Ellington,SG,33,DET,46,31,1012,149,338,.441,116,275,.422,33,63,.524,.612,28,35,.800,12,73,85,67,18,9,33,59,442
2021,Joel Embiid,C,26,PHI,51,51,1585,461,899,.513,58,154,.377,403,745,.541,.545,471,548,.859,113,426,539,145,50,69,159,123,1451
2021,James Ennis III,SF,30,ORL,41,37,986,115,243,.473,45,104,.433,70,139,.504,.566,70,87,.805,43,123,166,62,32,7,36,84,345
2021,Drew Eubanks,C,23,SAS,54,3,755,116,205,.566,2,2,1.000,114,203,.562,.571,77,106,.726,74,167,241,42,18,49,45,88,311
2021,Dante Exum,SG,25,CLE,6,3,116,10,26,.385,2,11,.182,8,15,.533,.423,1,2,.500,2,15,17,13,4,2,7,9,23
2021,Tacko Fall,C,25,BOS,19,0,136,21,29,.724,0,0,,21,29,.724,.724,5,15,.333,16,36,52,3,1,20,6,22,47
2021,Derrick Favors,C,29,UTA,68,0,1039,155,243,.638,0,2,.000,155,241,.643,.638,59,80,.738,138,238,376,44,32,68,36,143,369
2021,Cristiano Felício,C,28,CHI,18,0,84,7,13,.538,0,2,.000,7,11,.636,.538,9,16,.563,10,16,26,9,4,0,4,10,23
2021,Terrance Ferguson,SG,22,PHI,13,0,49,1,7,.143,0,5,.000,1,2,.500,.143,0,0,,0,1,1,2,1,0,4,7,2
2021,Bruno Fernando,C,22,ATL,33,0,226,18,44,.409,0,2,.000,18,42,.429,.409,15,22,.682,16,62,78,10,4,3,21,23,51
2021,Yogi Ferrell,PG,27,TOT,10,0,136,20,57,.351,9,28,.321,11,29,.379,.430,7,9,.778,5,14,19,22,7,3,3,11,56
2021,Dorian Finney-Smith,PF,27,DAL,60,60,1921,220,466,.472,119,302,.394,101,164,.616,.600,31,41,.756,98,228,326,102,52,25,48,138,590
2021,Malik Fitts,PF,23,LAC,3,0,11,1,3,.333,1,2,.500,0,1,.000,.500,0,0,,0,3,3,0,0,0,0,3,3
2021,Malachi Flynn,PG,22,TOR,47,14,928,127,340,.374,54,168,.321,73,172,.424,.453,45,56,.804,10,106,116,137,38,7,43,68,353
2021,Bryn Forbes,SG,27,MIL,70,10,1354,250,529,.473,154,341,.452,96,188,.511,.618,47,61,.770,11,101,112,45,24,1,44,77,701
2021,Trent Forrest,PG,22,UTA,30,0,302,32,71,.451,5,26,.192,27,45,.600,.486,19,19,1.000,11,33,44,45,9,4,21,22,88
2021,Evan Fournier,SF-SG,28,TOT,42,36,1259,247,541,.457,117,283,.413,130,258,.504,.565,108,137,.788,10,118,128,144,47,19,73,96,719
2021,De'Aaron Fox,PG,23,SAC,58,58,2036,529,1110,.477,103,320,.322,426,790,.539,.523,300,417,.719,33,170,203,417,87,27,174,170,1461
2021,Robert Franks,PF,24,ORL,7,0,101,13,28,.464,5,15,.333,8,13,.615,.554,12,13,.923,6,8,14,5,3,3,2,8,43
2021,Tim Frazier,PG,30,MEM,5,0,62,3,20,.150,0,8,.000,3,12,.250,.150,2,6,.333,0,8,8,16,2,1,4,7,8
2021,Enes Freedom,C,28,POR,72,35,1758,339,561,.604,1,4,.250,338,557,.607,.605,127,164,.774,284,511,795,84,33,48,78,168,806
2021,Markelle Fultz,PG,22,ORL,8,8,215,41,104,.394,4,16,.250,37,88,.420,.413,17,19,.895,5,20,25,43,8,2,18,18,103
2021,Wenyen Gabriel,PF,23,NOP,21,0,241,24,60,.400,13,32,.406,11,28,.393,.508,11,17,.647,20,34,54,11,9,8,15,32,72
2021,Daniel Gafford,PF-C,22,TOT,54,11,791,154,225,.684,0,0,,154,225,.684,.684,72,108,.667,94,137,231,29,26,75,41,98,380
2021,Danilo Gallinari,PF,32,ATL,51,4,1222,206,475,.434,103,254,.406,103,221,.466,.542,161,174,.925,17,194,211,76,30,10,43,105,676
2021,Langston Galloway,SG,29,PHO,40,0,438,66,147,.449,36,85,.424,30,62,.484,.571,22,23,.957,7,35,42,26,8,0,13,25,190
2021,Darius Garland,PG,21,CLE,54,50,1790,362,802,.451,105,266,.395,257,536,.479,.517,112,132,.848,23,106,129,329,66,6,164,110,941
2021,Marc Gasol,C,36,LAL,52,42,993,88,194,.454,50,122,.410,38,72,.528,.582,36,50,.720,38,177,215,109,26,58,53,115,262
2021,Rudy Gay,PF,34,SAS,63,1,1358,264,628,.420,106,278,.381,158,350,.451,.505,82,102,.804,42,261,303,88,45,40,65,115,716
2021,Paul George,SF,30,LAC,54,54,1821,445,953,.467,171,416,.411,274,537,.510,.557,198,228,.868,45,314,359,280,62,24,179,132,1259
2021,Taj Gibson,C,35,NYK,45,3,936,99,158,.627,3,15,.200,96,143,.671,.636,40,55,.727,99,151,250,36,31,49,22,99,241
2021,Harry Giles,C,22,POR,38,0,348,42,97,.433,8,23,.348,34,74,.459,.474,16,27,.593,31,102,133,29,8,13,20,54,108
2021,Shai Gilgeous-Alexander,SG,22,OKC,35,35,1180,287,565,.508,71,170,.418,216,395,.547,.571,185,229,.808,19,147,166,207,27,23,106,70,830
2021,Anthony Gill,PF,28,WAS,26,4,218,30,60,.500,7,24,.292,23,36,.639,.558,13,16,.813,16,35,51,11,10,4,8,27,80
2021,Freddie Gillespie,PF,23,TOR,20,2,392,44,84,.524,0,0,,44,84,.524,.524,23,33,.697,42,55,97,9,13,20,12,43,111
2021,Rudy Gobert,C,28,UTA,71,71,2187,391,579,.675,0,4,.000,391,575,.680,.675,233,374,.623,240,720,960,89,40,190,118,163,1015
2021,Brandon Goodwin,PG,25,ATL,47,5,620,84,223,.377,32,103,.311,52,120,.433,.448,28,43,.651,8,61,69,95,17,0,36,41,228
2021,Aaron Gordon,PF,25,TOT,50,50,1384,231,499,.463,59,176,.335,172,323,.533,.522,97,149,.651,77,207,284,161,33,34,97,89,618
2021,Eric Gordon,SG,32,HOU,27,13,789,159,367,.433,69,210,.329,90,157,.573,.527,94,114,.825,8,50,58,71,14,13,51,44,481
2021,Devonte' Graham,PG,25,CHO,55,44,1659,252,669,.377,179,477,.375,73,192,.380,.510,133,158,.842,22,126,148,295,48,6,84,77,816
2021,Jerami Grant,SF,26,DET,54,54,1829,400,932,.429,115,329,.350,285,603,.473,.491,290,343,.845,35,215,250,152,35,58,109,125,1205
2021,Danny Green,SF,33,PHI,69,69,1934,224,544,.412,175,432,.405,49,112,.438,.573,31,40,.775,55,205,260,118,92,56,67,125,654
2021,Draymond Green,PF,30,GSW,63,63,1982,170,380,.447,34,126,.270,136,254,.535,.492,70,88,.795,55,394,449,558,105,52,188,194,444
2021,JaMychal Green,PF,30,DEN,58,5,1120,173,374,.463,79,198,.399,94,176,.534,.568,46,57,.807,85,192,277,53,26,22,53,144,471
2021,Javonte Green,SF-SG,27,TOT,41,2,473,53,102,.520,10,30,.333,43,72,.597,.569,30,40,.750,26,45,71,17,28,6,19,45,146
2021,Jeff Green,C,34,BRK,68,38,1835,261,530,.492,103,250,.412,158,280,.564,.590,125,161,.776,34,229,263,108,36,27,54,122,750
2021,Josh Green,SG,20,DAL,39,5,445,42,93,.452,4,25,.160,38,68,.559,.473,13,23,.565,28,50,78,28,16,3,17,35,101
2021,Blake Griffin,PF,31,TOT,46,30,1186,174,411,.423,70,205,.341,104,206,.505,.509,87,117,.744,35,190,225,140,32,15,62,111,505
2021,Kyle Guy,PG,23,SAC,31,0,235,29,88,.330,13,46,.283,16,42,.381,.403,16,20,.800,5,30,35,32,6,0,11,20,87
2021,Rui Hachimura,PF,22,WAS,57,57,1797,310,648,.478,45,137,.328,265,511,.519,.513,124,161,.770,49,263,312,82,44,7,68,120,789
2021,Ashton Hagans,PG,21,MIN,2,0,4,0,0,,0,0,,0,0,,,0,0,,0,0,0,0,0,0,1,0,0
2021,Tyrese Haliburton,PG,20,SAC,58,20,1746,292,619,.472,121,296,.409,171,323,.529,.569,48,56,.857,39,134,173,309,77,28,92,83,753
2021,Donta Hall,PF,23,ORL,13,0,179,25,35,.714,0,0,,25,35,.714,.714,23,34,.676,24,38,62,11,5,10,8,18,73
2021,Josh Hall,SF,20,OKC,21,1,336,30,99,.303,4,37,.108,26,62,.419,.323,22,44,.500,6,53,59,28,4,1,25,37,86
2021,R.J. Hampton,SG-PG,19,TOT,51,1,888,136,313,.435,27,87,.310,109,226,.482,.478,55,82,.671,29,150,179,87,21,10,53,61,354
2021,Tim Hardaway Jr.,SG,28,DAL,70,31,1985,407,911,.447,207,529,.391,200,382,.524,.560,142,174,.816,20,209,229,126,31,11,64,111,1163
2021,James Harden,PG-SG,31,TOT,44,43,1609,342,734,.466,121,334,.362,221,400,.553,.548,278,323,.861,35,313,348,475,53,33,177,99,1083
2021,Maurice Harkless,PF-SF,27,TOT,37,23,772,69,165,.418,23,84,.274,46,81,.568,.488,33,43,.767,13,76,89,44,30,20,22,86,194
2021,Jared Harper,PG,23,NYK,8,0,16,0,4,.000,0,1,.000,0,3,.000,.000,3,4,.750,0,2,2,1,0,0,3,1,3
2021,Montrezl Harrell,C,27,LAL,69,1,1580,375,603,.622,0,10,.000,375,593,.632,.622,181,256,.707,158,270,428,73,46,49,74,128,931
2021,Gary Harris,SG,26,TOT,39,38,1080,138,345,.400,48,141,.340,90,204,.441,.470,64,78,.821,21,58,79,78,28,11,37,71,388
2021,Jalen Harris,SG,22,TOR,13,2,172,36,72,.500,17,36,.472,19,36,.528,.618,7,9,.778,3,15,18,17,8,0,14,15,96
2021,Joe Harris,SF,29,BRK,69,65,2141,357,707,.505,211,444,.475,146,263,.555,.654,49,63,.778,43,205,248,130,46,14,62,141,974
2021,Tobias Harris,PF,28,PHI,62,62,2014,473,924,.512,82,208,.394,391,716,.546,.556,182,204,.892,62,357,419,220,55,51,107,119,1210
2021,Shaquille Harrison,SG,27,TOT,34,0,333,26,78,.333,3,16,.188,23,62,.371,.353,18,22,.818,7,41,48,25,17,5,11,33,73
2021,Josh Hart,SF,25,NOP,47,4,1349,151,344,.439,63,193,.326,88,151,.583,.531,69,89,.775,53,324,377,109,38,12,49,111,434
2021,Isaiah Hartenstein,C,22,TOT,46,2,559,94,171,.550,2,6,.333,92,165,.558,.556,46,71,.648,65,116,181,55,19,39,44,104,236
2021,Udonis Haslem,C,40,MIA,1,0,3,2,2,1.000,0,0,,2,2,1.000,1.000,0,0,,0,1,1,0,0,0,0,0,4
2021,Jaxson Hayes,C,20,NOP,60,3,964,175,280,.625,6,14,.429,169,266,.635,.636,93,120,.775,92,165,257,35,25,38,39,101,449
2021,Killian Hayes,PG,19,DET,26,18,670,71,201,.353,20,72,.278,51,129,.395,.403,14,17,.824,6,63,69,138,27,10,83,57,176
2021,Gordon Hayward,SF,30,CHO,44,44,1496,311,658,.473,85,205,.415,226,453,.499,.537,156,185,.843,37,221,258,181,52,14,91,74,863
2021,Juancho Hernangómez,PF,25,MIN,52,6,900,130,299,.435,55,168,.327,75,131,.573,.527,60,97,.619,45,160,205,35,19,7,27,52,375
2021,Willy Hernangómez,C,26,NOP,47,12,846,151,268,.563,1,10,.100,150,258,.581,.565,62,93,.667,117,217,334,50,22,23,34,68,365
2021,Tyler Herro,SG,21,MIA,54,15,1635,307,699,.439,107,297,.360,200,402,.498,.516,94,117,.803,25,243,268,184,35,17,101,71,815
2021,Buddy Hield,SG,28,SAC,71,71,2433,403,992,.406,282,721,.391,121,271,.446,.548,88,104,.846,29,305,334,257,63,30,130,175,1176
2021,George Hill,PG,34,TOT,30,17,672,95,197,.482,31,80,.388,64,117,.547,.561,40,50,.800,16,45,61,73,23,5,31,31,261
2021,Solomon Hill,PF,29,ATL,71,16,1513,107,298,.359,68,212,.321,39,86,.453,.473,35,46,.761,42,172,214,75,50,11,42,116,317
2021,Nate Hinton,SG,21,DAL,21,0,93,15,42,.357,4,19,.211,11,23,.478,.405,7,10,.700,1,8,9,8,7,2,5,8,41
2021,Jaylen Hoard,SF,21,OKC,19,0,320,44,88,.500,0,11,.000,44,77,.571,.500,28,41,.683,21,44,65,24,13,5,17,19,116
2021,Aaron Holiday,PG,24,IND,66,8,1176,170,436,.390,67,182,.368,103,254,.406,.467,68,83,.819,15,74,89,123,46,13,66,94,475
2021,Jrue Holiday,PG,30,MIL,59,56,1907,414,823,.503,111,283,.392,303,540,.561,.570,107,136,.787,73,195,268,357,96,37,127,98,1046
2021,Justin Holiday,SG,31,IND,72,52,2183,258,625,.413,173,453,.382,85,172,.494,.551,67,85,.788,32,224,256,119,74,41,54,135,756
2021,Rondae Hollis-Jefferson,PF,26,POR,11,1,107,9,18,.500,0,1,.000,9,17,.529,.500,9,16,.563,11,15,26,13,2,4,2,15,27
2021,Richaun Holmes,C,27,SAC,61,61,1782,366,575,.637,2,11,.182,364,564,.645,.638,135,170,.794,144,360,504,101,39,96,75,213,869
2021,Rodney Hood,SF,28,TOT,55,5,942,94,260,.362,34,113,.301,60,147,.408,.427,24,28,.857,23,80,103,53,24,7,36,74,246
2021,Al Horford,C,34,OKC,28,28,782,162,360,.450,56,152,.368,106,208,.510,.528,18,22,.818,29,159,188,94,25,26,29,48,398
2021,Talen Horton-Tucker,SG,20,LAL,65,4,1304,224,489,.458,37,131,.282,187,358,.522,.496,100,129,.775,25,144,169,181,63,21,105,127,585
2021,Danuel House Jr.,SF,27,HOU,36,23,932,110,272,.404,54,156,.346,56,116,.483,.504,41,63,.651,18,114,132,69,20,16,36,67,315
2021,Dwight Howard,C,35,PHI,69,6,1196,178,303,.587,5,20,.250,173,283,.611,.596,121,210,.576,190,390,580,61,30,62,112,200,482
2021,Markus Howard,SG,21,DEN,37,1,205,40,106,.377,18,65,.277,22,41,.537,.462,7,9,.778,1,20,21,18,4,1,18,23,105
2021,Kevin Huerter,SG,22,ATL,69,49,2126,316,731,.432,140,386,.363,176,345,.510,.528,50,64,.781,38,193,231,241,82,18,79,165,822
2021,Elijah Hughes,SF,22,UTA,18,0,64,10,30,.333,8,23,.348,2,7,.286,.467,3,4,.750,1,8,9,6,1,1,6,1,31
2021,De'Andre Hunter,SF,23,ATL,23,19,678,120,248,.484,31,95,.326,89,153,.582,.546,73,85,.859,17,93,110,44,19,12,29,59,344
2021,Chandler Hutchison,SF,24,TOT,25,1,346,39,103,.379,8,22,.364,31,81,.383,.417,21,25,.840,6,72,78,17,12,5,20,33,107
2021,Serge Ibaka,C,31,LAC,41,39,955,186,365,.510,39,115,.339,147,250,.588,.563,43,53,.811,73,202,275,74,9,47,44,76,454
2021,Andre Iguodala,SF,37,MIA,63,5,1339,95,248,.383,60,182,.330,35,66,.530,.504,25,38,.658,38,183,221,142,57,35,67,90,275
2021,Ersan İlyasova,PF,33,UTA,17,1,148,21,54,.389,18,41,.439,3,13,.231,.556,5,5,1.000,7,22,29,4,10,3,8,29,65
2021,Joe Ingles,SF,33,UTA,67,30,1867,275,562,.489,183,406,.451,92,156,.590,.652,76,90,.844,27,217,244,318,45,12,117,120,809
2021,Brandon Ingram,SF,23,NOP,61,61,2093,513,1101,.466,143,375,.381,370,726,.510,.531,281,320,.878,34,265,299,296,42,36,154,124,1450
2021,Kyrie Irving,PG,28,BRK,54,54,1886,549,1086,.506,152,378,.402,397,708,.561,.576,201,218,.922,52,205,257,324,76,37,130,140,1451
2021,Wes Iwundu,SF,26,TOT,41,4,539,34,102,.333,5,41,.122,29,61,.475,.358,26,31,.839,15,75,90,18,15,4,19,49,99
2021,Frank Jackson,PG,22,DET,40,6,738,134,293,.457,61,150,.407,73,143,.510,.561,61,75,.813,15,71,86,36,15,1,34,53,390
2021,Jaren Jackson Jr.,C,21,MEM,11,4,258,53,125,.424,17,60,.283,36,65,.554,.492,35,42,.833,17,45,62,12,12,18,15,42,158
2021,Josh Jackson,SG,23,DET,62,25,1560,296,707,.419,77,257,.300,219,450,.487,.473,159,218,.729,57,197,254,143,53,47,142,178,828
2021,Justin Jackson,SF,25,TOT,34,3,577,89,221,.403,36,117,.308,53,104,.510,.484,31,37,.838,16,61,77,52,15,2,32,32,245
2021,Reggie Jackson,SG,30,LAC,67,43,1544,263,585,.450,122,282,.433,141,303,.465,.554,67,82,.817,24,168,192,205,41,7,74,127,715
2021,Justin James,SF,24,SAC,36,0,310,52,111,.468,14,38,.368,38,73,.521,.532,21,36,.583,9,21,30,22,8,3,15,23,139
2021,LeBron James,PG,36,LAL,45,45,1504,422,823,.513,104,285,.365,318,538,.591,.576,178,255,.698,29,317,346,350,48,25,168,70,1126
2021,Mike James,PG,30,BRK,13,1,236,34,92,.370,11,31,.355,23,61,.377,.429,21,27,.778,3,29,32,54,6,1,20,10,100
2021,DaQuan Jeffries,SG,23,TOT,31,5,493,50,120,.417,20,67,.299,30,53,.566,.500,7,8,.875,19,52,71,22,15,10,14,48,127
2021,Ty Jerome,SG,23,OKC,33,1,788,128,287,.446,71,168,.423,57,119,.479,.570,26,34,.765,10,81,91,120,20,6,47,61,353
2021,Isaiah Joe,SG,21,PHI,41,1,383,48,133,.361,39,106,.368,9,27,.333,.508,18,24,.750,6,30,36,20,12,4,11,34,153
2021,Alize Johnson,PF,24,BRK,18,0,189,40,68,.588,1,6,.167,39,62,.629,.596,13,13,1.000,27,63,90,14,5,5,9,16,94
2021,Cameron Johnson,PF,24,PHO,60,11,1437,203,483,.420,117,335,.349,86,148,.581,.541,50,59,.847,33,166,199,86,37,16,40,85,573
2021,James Johnson,PF,33,TOT,51,12,1043,146,327,.446,31,120,.258,115,207,.556,.494,45,76,.592,32,145,177,98,42,42,55,120,368
2021,Keldon Johnson,SF,21,SAS,69,67,1968,338,705,.479,60,181,.331,278,524,.531,.522,145,196,.740,93,319,412,121,40,24,78,142,881
2021,Stanley Johnson,PF,24,TOR,61,13,1006,89,233,.382,45,137,.328,44,96,.458,.479,44,55,.800,29,124,153,89,52,18,54,116,267
2021,Tyler Johnson,SG,28,BRK,39,3,684,72,183,.393,48,132,.364,24,51,.471,.525,18,21,.857,6,71,77,47,14,0,17,43,210
2021,Nikola Jokić,C,25,DEN,72,72,2488,732,1293,.566,92,237,.388,640,1056,.606,.602,342,394,.868,205,575,780,599,95,48,222,192,1898
2021,Damian Jones,C,25,TOT,39,10,547,70,103,.680,1,5,.200,69,98,.704,.684,42,58,.724,36,85,121,29,11,29,26,77,183
2021,Derrick Jones Jr.,SF,23,POR,58,43,1318,147,304,.484,43,136,.316,104,168,.619,.554,59,91,.648,77,128,205,47,37,54,32,127,396
2021,Mason Jones,SG,22,TOT,32,1,334,52,123,.423,24,66,.364,28,57,.491,.520,40,64,.625,7,48,55,42,7,1,29,24,168
2021,Tre Jones,PG,21,SAS,37,1,269,37,78,.474,3,5,.600,34,73,.466,.494,17,19,.895,8,13,21,39,8,0,13,13,94
2021,Tyus Jones,PG,24,MEM,70,9,1222,178,413,.431,45,140,.321,133,273,.487,.485,41,45,.911,21,119,140,259,64,6,48,31,442
2021,DeAndre Jordan,C,32,BRK,57,43,1246,190,249,.763,0,1,.000,190,248,.766,.763,46,92,.500,117,310,427,93,17,65,85,116,426
2021,Cory Joseph,PG,29,TOT,63,13,1446,200,426,.469,45,132,.341,155,294,.527,.522,72,88,.818,35,124,159,213,61,18,79,139,517
2021,Mfiondu Kabengele,PF,23,TOT,39,0,280,33,89,.371,13,50,.260,20,39,.513,.444,16,20,.800,12,48,60,17,8,13,15,36,95
2021,Frank Kaminsky,C,27,PHO,47,13,715,121,257,.471,31,85,.365,90,172,.523,.531,37,60,.617,36,152,188,79,14,17,22,70,310
2021,Luke Kennard,SG,24,LAC,63,17,1232,197,414,.476,100,224,.446,97,190,.511,.597,26,31,.839,15,146,161,104,23,9,48,91,520
2021,Louis King,SF,21,SAC,6,1,85,17,34,.500,4,11,.364,13,23,.565,.559,6,6,1.000,5,13,18,9,7,3,4,9,44
2021,Maxi Kleber,PF,29,DAL,50,40,1341,116,275,.422,87,212,.410,29,63,.460,.580,34,37,.919,47,213,260,68,24,35,30,105,353
2021,Nathan Knight,PF,23,ATL,33,0,279,37,100,.370,6,33,.182,31,67,.463,.400,44,55,.800,27,45,72,8,9,10,15,22,124
2021,Kevin Knox,SF,21,NYK,42,0,464,56,143,.392,35,89,.393,21,54,.389,.514,16,20,.800,10,51,61,19,12,6,17,37,163
2021,John Konchar,SG,24,MEM,43,0,575,69,138,.500,21,56,.375,48,82,.585,.576,25,30,.833,35,93,128,47,30,9,18,40,184
2021,Furkan Korkmaz,SG,23,PHI,55,11,1062,170,424,.401,101,269,.375,69,155,.445,.520,60,82,.732,17,96,113,82,49,9,46,64,501
2021,Luke Kornet,C-PF,25,TOT,31,2,348,44,101,.436,15,59,.254,29,42,.690,.510,3,6,.500,14,53,67,24,4,32,7,20,106
2021,Rodions Kurucs,SF-PF,22,TOT,21,0,125,11,32,.344,6,21,.286,5,11,.455,.438,3,4,.750,5,18,23,10,9,4,13,16,31
2021,Kyle Kuzma,SF,25,LAL,68,32,1954,335,757,.443,137,380,.361,198,377,.525,.533,67,97,.691,108,309,417,127,35,41,113,121,874
2021,Anthony Lamb,SF,23,HOU,24,3,415,46,118,.390,23,71,.324,23,47,.489,.487,18,21,.857,27,43,70,23,6,5,19,34,133
2021,Jeremy Lamb,SG,28,IND,36,8,765,120,276,.435,52,128,.406,68,148,.459,.529,71,75,.947,25,106,131,53,34,23,22,72,363
2021,Romeo Langford,SG,21,BOS,18,4,283,21,59,.356,5,18,.278,16,41,.390,.398,9,12,.750,12,23,35,13,6,5,10,24,56
2021,Zach LaVine,SG,25,CHI,58,58,2034,569,1123,.507,200,477,.419,369,646,.571,.596,253,298,.849,36,253,289,282,46,27,203,138,1591
2021,Jake Layman,SF,26,MIN,45,11,627,91,184,.495,23,78,.295,68,106,.642,.557,26,37,.703,13,54,67,28,29,19,26,44,231
2021,T.J. Leaf,PF,23,POR,7,0,35,5,10,.500,0,0,,5,10,.500,.500,2,2,1.000,0,5,5,1,2,1,2,1,12
2021,Jalen Lecque,PG,20,IND,4,0,12,1,9,.111,0,1,.000,1,8,.125,.111,3,3,1.000,2,3,5,2,0,0,0,0,5
2021,Damion Lee,SG,28,GSW,57,1,1079,128,274,.467,77,194,.397,51,80,.638,.608,40,44,.909,22,158,180,73,38,8,30,89,373
2021,Saben Lee,PG,21,DET,48,7,781,99,210,.471,8,23,.348,91,187,.487,.490,61,89,.685,20,77,97,174,32,13,55,76,267
2021,Alex Len,C,27,TOT,64,42,979,171,278,.615,8,25,.320,163,253,.644,.629,73,116,.629,78,182,260,49,20,64,55,127,423
2021,Kawhi Leonard,SF,29,LAC,52,52,1773,465,908,.512,101,254,.398,364,654,.557,.568,261,295,.885,55,282,337,269,81,21,105,82,1292
2021,Meyers Leonard,C,28,MIA,3,2,29,3,7,.429,3,7,.429,0,0,,.643,1,2,.500,0,7,7,2,0,0,2,5,10
2021,Caris LeVert,SG,26,TOT,47,39,1486,359,814,.441,84,258,.326,275,556,.495,.493,146,180,.811,33,181,214,245,66,30,102,105,948
2021,Kira Lewis Jr.,PG,19,NOP,54,0,904,130,337,.386,40,120,.333,90,217,.415,.445,43,51,.843,12,59,71,124,38,10,34,88,343
2021,Damian Lillard,PG,30,POR,67,67,2398,602,1334,.451,275,704,.391,327,630,.519,.554,449,484,.928,32,251,283,505,62,17,203,102,1928
2021,Nassir Little,PF,20,POR,48,2,640,78,167,.467,28,80,.350,50,87,.575,.551,36,45,.800,32,96,128,23,5,13,18,51,220
2021,Kevon Looney,C,24,GSW,61,34,1161,108,197,.548,4,17,.235,104,180,.578,.558,31,48,.646,117,205,322,119,21,22,37,136,251
2021,Brook Lopez,C,32,MIL,70,70,1902,322,640,.503,95,281,.338,227,359,.632,.577,120,142,.845,104,243,347,50,40,103,64,149,859
2021,Robin Lopez,C,32,WAS,71,9,1354,269,425,.633,5,18,.278,264,407,.649,.639,99,137,.723,141,131,272,55,15,44,75,109,642
2021,Didi Louzada,SF,21,NOP,3,0,56,3,13,.231,2,8,.250,1,5,.200,.308,0,0,,1,2,3,3,2,0,3,5,8
2021,Kevin Love,PF,32,CLE,25,25,622,103,252,.409,57,156,.365,46,96,.479,.522,42,51,.824,17,169,186,63,16,2,38,26,305
2021,Kyle Lowry,PG,34,TOR,46,46,1601,260,596,.436,131,331,.396,129,265,.487,.546,140,160,.875,35,212,247,338,45,14,126,143,791
2021,Timothé Luwawu-Cabarrot,SF,25,BRK,58,7,1050,130,356,.365,75,239,.314,55,117,.470,.471,35,43,.814,28,101,129,69,33,6,43,99,370
2021,Trey Lyles,PF,25,SAS,23,9,358,43,90,.478,14,40,.350,29,50,.580,.556,15,23,.652,9,77,86,14,6,1,6,13,115
2021,Will Magnay,C,22,NOP,1,0,3,0,1,.000,0,1,.000,0,0,,.000,0,0,,0,0,0,0,0,0,1,1,0
2021,Thon Maker,C,23,CLE,8,0,76,10,18,.556,0,2,.000,10,16,.625,.556,10,11,.909,8,10,18,4,2,4,3,7,30
2021,Théo Maledon,PG,19,OKC,65,49,1778,226,614,.368,105,313,.335,121,301,.402,.454,101,135,.748,25,186,211,227,56,11,141,126,658
2021,Karim Mané,PG,20,ORL,10,0,88,3,13,.231,1,2,.500,2,11,.182,.269,4,5,.800,1,13,14,4,0,2,3,10,11
2021,Terance Mann,SG,24,LAC,67,10,1263,178,350,.509,38,91,.418,140,259,.541,.563,78,94,.830,56,186,242,104,29,13,40,126,472
2021,Nico Mannion,PG,19,GSW,30,1,364,39,114,.342,22,60,.367,17,54,.315,.439,23,28,.821,6,40,46,70,16,1,31,29,123
2021,Boban Marjanović,C,32,DAL,33,3,271,62,122,.508,1,8,.125,61,114,.535,.512,31,38,.816,47,81,128,10,2,6,12,29,156
2021,Lauri Markkanen,PF,23,CHI,51,26,1317,250,521,.480,119,296,.402,131,225,.582,.594,76,92,.826,35,233,268,45,26,15,52,75,695
2021,Naji Marshall,SF,23,NOP,32,10,700,82,209,.392,29,83,.349,53,126,.421,.462,53,75,.707,15,133,148,88,26,10,38,58,246
2021,Caleb Martin,SF,25,CHO,53,3,818,96,256,.375,31,125,.248,65,131,.496,.436,41,64,.641,31,110,141,67,37,12,33,62,264
2021,Cody Martin,SF,25,CHO,52,10,849,83,188,.441,16,58,.276,67,130,.515,.484,25,43,.581,52,109,161,86,37,12,40,52,207
2021,Jeremiah Martin,PG,24,CLE,9,0,75,9,33,.273,3,12,.250,6,21,.286,.318,1,5,.200,2,5,7,4,5,2,6,1,22
2021,Kelan Martin,SF,25,IND,35,0,322,62,138,.449,24,60,.400,38,78,.487,.536,9,10,.900,18,60,78,17,10,10,16,35,157
2021,Kenyon Martin Jr.,SF,20,HOU,45,8,1068,162,318,.509,35,96,.365,127,222,.572,.564,60,84,.714,73,169,242,48,30,41,38,89,419
2021,Frank Mason III,PG,26,ORL,4,1,79,9,24,.375,2,5,.400,7,19,.368,.417,5,7,.714,3,9,12,12,0,0,5,7,25
2021,Garrison Mathews,SG,24,WAS,64,24,1038,97,237,.409,76,198,.384,21,39,.538,.570,84,95,.884,16,71,87,26,29,7,10,106,354
2021,Dakota Mathias,SG,25,PHI,8,2,123,19,48,.396,8,26,.308,11,22,.500,.479,2,6,.333,1,6,7,13,1,3,1,7,48
2021,Wesley Matthews,SG,34,LAL,58,10,1130,89,252,.353,66,197,.335,23,55,.418,.484,35,41,.854,20,73,93,54,38,17,26,80,279
2021,Tyrese Maxey,SG,20,PHI,61,8,935,198,429,.462,31,103,.301,167,326,.512,.498,61,70,.871,11,93,104,120,26,13,41,79,488
2021,Skylar Mays,SG,23,ATL,33,0,269,44,98,.449,14,40,.350,30,58,.517,.520,22,25,.880,10,25,35,30,14,2,9,15,124
2021,Patrick McCaw,SF,25,TOR,5,0,33,1,1,1.000,0,0,,1,1,1.000,1.000,3,3,1.000,1,2,3,4,2,0,0,6,5
2021,CJ McCollum,SG,29,POR,47,47,1600,405,884,.458,169,420,.402,236,464,.509,.554,108,133,.812,30,155,185,223,44,21,65,87,1087
2021,T.J. McConnell,PG,28,IND,69,3,1796,274,490,.559,15,48,.313,259,442,.586,.574,33,48,.688,55,201,256,456,128,23,135,113,596
2021,Jaden McDaniels,PF,20,MIN,63,27,1511,164,367,.447,72,198,.364,92,169,.544,.545,27,45,.600,52,180,232,71,35,60,47,172,427
2021,Jalen McDaniels,SF,23,CHO,47,18,904,133,284,.468,35,105,.333,98,179,.547,.530,45,64,.703,45,124,169,53,28,19,45,95,346
2021,Doug McDermott,PF,29,IND,66,29,1619,354,665,.532,111,286,.388,243,379,.641,.616,80,98,.816,60,161,221,85,20,6,53,117,899
2021,Sean McDermott,SF,24,MEM,18,0,158,13,33,.394,5,22,.227,8,11,.727,.470,8,8,1.000,6,13,19,4,2,3,4,8,39
2021,JaVale McGee,C,33,TOT,46,2,678,144,282,.511,5,24,.208,139,258,.539,.520,44,67,.657,77,162,239,39,19,54,60,121,337
2021,Rodney McGruder,SG,29,DET,16,2,194,37,70,.529,11,24,.458,26,46,.565,.607,6,8,.750,8,14,22,16,8,1,7,12,91
2021,Alfonzo McKinnie,SF,28,LAL,39,0,258,48,93,.516,16,39,.410,32,54,.593,.602,10,18,.556,22,32,54,6,7,0,5,26,122
2021,Jordan McLaughlin,PG,24,MIN,51,2,938,100,242,.413,33,92,.359,67,150,.447,.481,23,30,.767,21,87,108,193,51,6,51,44,256
2021,Ben McLemore,SG,27,TOT,53,5,905,135,365,.370,97,280,.346,38,85,.447,.503,39,53,.736,15,85,100,39,23,9,42,88,406
2021,Nicolò Melli,PF,30,TOT,45,4,566,46,141,.326,23,85,.271,23,56,.411,.408,19,25,.760,29,93,122,44,14,3,12,58,134
2021,De'Anthony Melton,PG,22,MEM,52,1,1045,172,393,.438,87,211,.412,85,182,.467,.548,41,51,.804,30,131,161,132,60,31,66,85,472
2021,Sam Merrill,SG,24,MIL,30,2,233,32,72,.444,21,47,.447,11,25,.440,.590,4,4,1.000,6,24,30,21,8,1,10,17,89
2021,Chimezie Metu,C,23,SAC,36,6,488,91,179,.508,13,37,.351,78,142,.549,.545,31,43,.721,31,81,112,28,14,18,29,59,226
2021,Khris Middleton,SF,29,MIL,68,68,2269,511,1074,.476,151,365,.414,360,709,.508,.546,212,236,.898,54,352,406,370,74,9,178,160,1385
2021,Darius Miller,SF,30,OKC,18,0,197,22,48,.458,17,42,.405,5,6,.833,.635,12,12,1.000,2,22,24,21,13,5,8,13,73
2021,Patty Mills,PG,32,SAS,68,1,1685,252,611,.412,161,429,.375,91,182,.500,.544,71,78,.910,18,98,116,162,42,3,66,81,736
2021,Paul Millsap,PF,35,DEN,56,36,1162,191,401,.476,49,143,.343,142,258,.550,.537,71,98,.724,76,186,262,98,51,36,51,111,502
2021,Shake Milton,SG,24,PHI,63,4,1461,300,667,.450,71,203,.350,229,464,.494,.503,146,176,.830,33,115,148,193,39,18,103,130,817
2021,Donovan Mitchell,PG,24,UTA,53,53,1771,478,1091,.438,178,461,.386,300,630,.476,.520,267,316,.845,50,185,235,277,52,15,147,117,1401
2021,Adam Mokoka,SG,22,CHI,14,0,56,7,19,.368,1,10,.100,6,9,.667,.395,0,1,.000,1,4,5,5,2,1,5,5,15
2021,Malik Monk,SG,22,CHO,42,0,878,173,399,.434,85,212,.401,88,187,.471,.540,59,72,.819,14,87,101,87,19,4,55,47,490
2021,E'Twaun Moore,SG,31,PHO,27,1,389,55,121,.455,11,35,.314,44,86,.512,.500,12,14,.857,14,31,45,40,15,5,23,32,133
2021,Ja Morant,PG,21,MEM,63,63,2053,430,957,.449,73,241,.303,357,716,.499,.487,271,372,.728,59,193,252,465,57,13,203,87,1204
2021,Juwan Morgan,PF,23,UTA,29,0,147,14,30,.467,4,13,.308,10,17,.588,.533,3,7,.429,9,19,28,9,4,1,4,21,35
2021,Marcus Morris,PF,31,LAC,57,29,1502,276,584,.473,140,296,.473,136,288,.472,.592,73,89,.820,35,199,234,58,34,15,57,117,765
2021,Markieff Morris,PF,31,LAL,61,27,1200,153,378,.405,65,209,.311,88,169,.521,.491,36,50,.720,48,218,266,73,22,19,54,105,407
2021,Monte Morris,PG,25,DEN,47,13,1196,186,387,.481,51,134,.381,135,253,.534,.547,58,73,.795,11,85,96,150,34,13,34,48,481
2021,Mychal Mulder,PG,26,GSW,60,6,766,119,265,.449,85,214,.397,34,51,.667,.609,14,22,.636,8,52,60,26,12,12,16,56,337
2021,Dejounte Murray,PG,24,SAS,67,67,2139,441,974,.453,63,199,.317,378,775,.488,.485,106,134,.791,58,415,473,363,101,7,117,135,1051
2021,Jamal Murray,PG,23,DEN,48,48,1704,378,792,.477,129,316,.408,249,476,.523,.559,133,153,.869,37,157,194,231,64,13,108,95,1018
2021,Mike Muscala,C,29,OKC,35,0,645,119,267,.446,68,184,.370,51,83,.614,.573,33,36,.917,19,113,132,28,8,11,21,54,339
2021,Svi Mykhailiuk,SF-SG,23,TOT,66,14,1324,208,506,.411,105,314,.334,103,192,.536,.515,38,50,.760,24,139,163,110,51,12,88,63,559
2021,Abdel Nader,SF,27,PHO,24,0,355,57,116,.491,18,43,.419,39,73,.534,.569,28,37,.757,7,55,62,19,10,9,19,34,160
2021,Larry Nance Jr.,PF,28,CLE,35,27,1091,128,272,.471,41,114,.360,87,158,.551,.546,30,49,.612,54,181,235,107,61,17,55,72,327
2021,Aaron Nesmith,SF,21,BOS,46,1,669,78,178,.438,40,108,.370,38,70,.543,.551,22,28,.786,28,99,127,23,15,9,23,87,218
2021,Raul Neto,PG,28,WAS,64,22,1403,209,447,.468,64,164,.390,145,283,.512,.539,75,85,.882,28,128,156,146,73,6,53,109,557
2021,Georges Niang,PF,27,UTA,72,10,1154,177,405,.437,124,292,.425,53,113,.469,.590,22,23,.957,28,148,176,59,25,8,51,116,500
2021,Zeke Nnaji,PF,20,DEN,42,1,397,50,104,.481,24,59,.407,26,45,.578,.596,12,15,.800,14,51,65,10,8,4,7,29,136
2021,Nerlens Noel,C,26,NYK,64,41,1547,137,223,.614,0,3,.000,137,220,.623,.614,50,70,.714,142,266,408,46,70,141,65,176,324
2021,Jaylen Nowell,SG,21,MIN,42,0,759,142,335,.424,50,150,.333,92,185,.497,.499,45,55,.818,19,76,95,62,22,12,28,72,379
2021,Frank Ntilikina,PG,22,NYK,33,4,322,29,79,.367,23,48,.479,6,31,.194,.513,8,18,.444,6,25,31,19,18,4,11,45,89
2021,Kendrick Nunn,PG,25,MIA,56,44,1650,319,658,.485,122,320,.381,197,338,.583,.578,56,60,.933,21,158,179,148,52,14,80,108,816
2021,James Nunnally,SF,30,NOP,9,0,48,5,13,.385,4,12,.333,1,1,1.000,.538,1,2,.500,2,7,9,3,0,0,2,1,15
2021,Jusuf Nurkić,C,26,POR,37,37,880,171,333,.514,12,30,.400,159,303,.525,.532,70,113,.619,86,246,332,125,38,39,73,103,424
2021,David Nwaba,SF,28,HOU,30,9,679,106,218,.486,17,63,.270,89,155,.574,.525,47,68,.691,40,78,118,31,30,21,17,60,276
2021,Jordan Nwora,SF,22,MIL,30,2,274,62,135,.459,28,62,.452,34,73,.466,.563,19,25,.760,9,51,60,7,16,7,24,22,171
2021,Royce O'Neale,SF,27,UTA,71,71,2241,175,394,.444,107,278,.385,68,116,.586,.580,39,46,.848,88,397,485,181,57,32,83,182,496
2021,Semi Ojeleye,PF,26,BOS,56,15,950,89,221,.403,58,158,.367,31,63,.492,.534,24,32,.750,31,116,147,37,17,0,21,56,260
2021,Jahlil Okafor,C,25,DET,27,2,347,63,102,.618,2,9,.222,61,93,.656,.627,17,24,.708,23,43,66,13,6,5,21,39,145
2021,Chuma Okeke,PF,22,ORL,45,19,1133,135,324,.417,49,141,.348,86,183,.470,.492,30,40,.750,42,139,181,101,48,22,38,48,349
2021,Josh Okogie,SG,22,MIN,59,37,1197,102,254,.402,29,108,.269,73,146,.500,.459,83,108,.769,63,93,156,63,54,28,43,123,316
2021,Onyeka Okongwu,C,20,ATL,50,4,601,96,149,.644,0,3,.000,96,146,.658,.644,36,57,.632,62,101,163,18,23,33,29,100,228
2021,Isaac Okoro,SG,20,CLE,67,67,2173,235,559,.420,62,214,.290,173,345,.501,.476,114,157,.726,68,138,206,128,62,24,86,185,646
2021,KZ Okpala,PF,21,MIA,37,9,447,36,96,.375,12,50,.240,24,46,.522,.438,8,15,.533,21,47,68,19,10,11,15,59,92
2021,Victor Oladipo,SG,28,TOT,33,33,1080,235,576,.408,78,239,.326,157,337,.466,.476,104,138,.754,12,148,160,151,46,14,83,81,652
2021,Cameron Oliver,SF,24,HOU,4,0,87,19,33,.576,4,13,.308,15,20,.750,.636,1,4,.250,5,16,21,5,2,4,3,11,43
2021,Kelly Olynyk,C-PF,29,TOT,70,62,1997,337,697,.484,126,368,.342,211,329,.641,.574,145,175,.829,87,402,489,203,79,42,126,207,945
2021,Miye Oni,SG,23,UTA,54,0,519,35,99,.354,30,88,.341,5,11,.455,.505,5,6,.833,23,61,84,28,11,8,16,61,105
2021,Cedi Osman,SF,25,CLE,59,26,1510,219,586,.374,99,324,.306,120,262,.458,.458,76,95,.800,38,163,201,174,53,9,80,119,613
2021,Daniel Oturu,C,21,LAC,30,0,161,22,52,.423,1,5,.200,21,47,.447,.433,9,12,.750,21,27,48,10,4,7,9,24,54
2021,Kelly Oubre Jr.,SF,25,GSW,55,50,1687,318,724,.439,90,285,.316,228,439,.519,.501,123,177,.695,82,247,329,73,57,42,70,121,849
2021,Jabari Parker,PF,25,TOT,13,0,165,30,55,.545,2,11,.182,28,44,.636,.564,10,13,.769,10,32,42,11,1,5,10,13,72
2021,Eric Paschall,PF,24,GSW,40,2,695,148,298,.497,18,54,.333,130,244,.533,.527,67,94,.713,28,100,128,51,12,7,43,68,381
2021,Anžejs Pasečņiks,C,25,WAS,1,0,6,0,1,.000,0,1,.000,0,0,,.000,0,0,,1,0,1,1,0,0,5,2,0
2021,Patrick Patterson,PF,31,LAC,38,5,582,72,165,.436,40,112,.357,32,53,.604,.558,13,17,.765,19,56,75,29,14,8,11,45,197
2021,Justin Patton,C,23,HOU,13,6,247,29,70,.414,9,34,.265,20,36,.556,.479,3,4,.750,14,35,49,14,12,14,4,34,70
2021,Chris Paul,PG,35,PHO,70,70,2199,439,879,.499,102,258,.395,337,621,.543,.557,169,181,.934,25,287,312,622,99,19,156,166,1149
2021,Cameron Payne,PG,26,PHO,60,1,1079,191,395,.484,73,166,.440,118,229,.515,.576,50,56,.893,16,128,144,217,36,16,60,97,505
2021,Elfrid Payton,PG,26,NYK,63,63,1484,269,622,.432,28,98,.286,241,524,.460,.455,73,107,.682,64,152,216,203,47,9,103,116,639
2021,Gary Payton II,PG,28,GSW,10,0,40,10,13,.769,2,4,.500,8,9,.889,.846,3,4,.750,2,9,11,1,6,1,1,8,25
2021,Norvel Pelle,C,27,TOT,13,0,84,8,15,.533,0,0,,8,15,.533,.533,4,6,.667,6,13,19,2,1,9,3,14,20
2021,Reggie Perry,PF,20,BRK,26,0,211,32,78,.410,4,21,.190,28,57,.491,.436,10,13,.769,27,46,73,14,6,6,15,40,78
2021,Theo Pinson,SG,25,NYK,17,0,34,1,9,.111,0,8,.000,1,1,1.000,.111,0,0,,0,5,5,1,0,0,1,4,2
2021,Mason Plumlee,C,30,DET,56,56,1499,234,381,.614,0,7,.000,234,374,.626,.614,113,169,.669,145,374,519,202,43,50,105,186,581
2021,Jakob Poeltl,C,25,SAS,69,51,1845,265,430,.616,0,0,,265,430,.616,.616,63,124,.508,219,328,547,134,47,123,83,172,593
2021,Vincent Poirier,C,27,PHI,10,0,39,3,12,.250,0,1,.000,3,11,.273,.250,2,6,.333,6,8,14,2,0,3,4,8,8
2021,Aleksej Pokusevski,PF,19,OKC,45,28,1090,139,408,.341,58,207,.280,81,201,.403,.412,31,42,.738,30,182,212,97,20,42,99,58,367
2021,Jordan Poole,SG,21,GSW,51,7,988,205,474,.432,97,276,.351,108,198,.545,.535,105,119,.882,15,77,92,99,26,9,51,86,612
2021,Jontay Porter,PF,21,MEM,11,0,54,8,15,.533,3,8,.375,5,7,.714,.633,3,5,.600,4,10,14,1,3,1,7,12,22
2021,Kevin Porter Jr.,SG,20,HOU,26,23,835,156,367,.425,50,161,.311,106,206,.515,.493,69,94,.734,20,79,99,164,19,8,91,61,431
2021,Michael Porter Jr.,SF,22,DEN,61,54,1912,443,817,.542,170,382,.445,273,435,.628,.646,106,134,.791,91,354,445,70,40,54,77,126,1162
2021,Otto Porter Jr.,SF-PF,27,TOT,28,6,606,98,227,.432,39,104,.375,59,123,.480,.518,36,42,.857,28,124,152,55,16,4,25,41,271
2021,Bobby Portis,C,25,MIL,66,7,1372,313,598,.523,74,157,.471,239,441,.542,.585,54,73,.740,124,342,466,71,52,26,56,115,754
2021,Kristaps Porziņģis,C,25,DAL,43,43,1327,325,683,.476,97,258,.376,228,425,.536,.547,118,138,.855,82,299,381,68,20,58,51,115,865
2021,Dwight Powell,C,29,DAL,58,19,966,120,194,.619,5,21,.238,115,173,.665,.631,97,124,.782,80,154,234,63,36,30,40,135,342
2021,Norman Powell,SG-SF,27,TOT,69,58,2205,438,918,.477,171,416,.411,267,502,.532,.570,236,271,.871,42,173,215,129,82,18,119,160,1283
2021,Taurean Prince,PF,26,TOT,41,10,905,131,327,.401,62,155,.400,69,172,.401,.495,65,76,.855,19,123,142,76,28,23,47,75,389
2021,Payton Pritchard,SG,23,BOS,66,4,1268,184,418,.440,102,248,.411,82,170,.482,.562,40,45,.889,33,125,158,120,37,9,53,104,510
2021,Immanuel Quickley,PG,21,NYK,64,3,1243,229,580,.395,118,303,.389,111,277,.401,.497,155,174,.891,25,112,137,127,30,12,58,114,731
2021,Jahmi'us Ramsey,SG,19,SAC,13,0,94,15,38,.395,5,19,.263,10,19,.526,.461,5,5,1.000,2,8,10,6,4,1,3,8,40
2021,Chasson Randle,PG,27,ORL,41,5,837,92,237,.388,44,130,.338,48,107,.449,.481,38,48,.792,7,75,82,74,22,5,46,64,266
2021,Julius Randle,PF,26,NYK,71,71,2667,602,1321,.456,160,389,.411,442,932,.474,.516,348,429,.811,84,639,723,427,64,18,241,225,1712
2021,Cam Reddish,SF,21,ATL,26,21,750,96,263,.365,33,126,.262,63,137,.460,.428,67,82,.817,22,82,104,35,33,9,34,68,292
2021,J.J. Redick,SG,36,TOT,44,0,723,106,267,.397,66,178,.371,40,89,.449,.521,49,52,.942,4,60,64,51,11,3,36,50,327
2021,Paul Reed,PF,21,PHI,26,0,177,42,78,.538,0,6,.000,42,72,.583,.538,4,8,.500,30,31,61,12,10,13,12,29,88
2021,Naz Reid,C,21,MIN,70,15,1347,304,581,.523,61,174,.351,243,407,.597,.576,115,166,.693,82,240,322,72,34,76,69,179,784
2021,Cameron Reynolds,SF,25,TOT,5,0,40,6,18,.333,3,12,.250,3,6,.500,.417,0,0,,2,3,5,2,0,0,0,2,15
2021,Nick Richards,PF,23,CHO,18,0,63,4,9,.444,0,1,.000,4,8,.500,.444,7,11,.636,4,7,11,2,0,0,3,7,15
2021,Josh Richardson,SG,27,DAL,59,56,1790,264,618,.427,88,267,.330,176,351,.501,.498,99,108,.917,51,144,195,153,61,24,79,130,715
2021,Grant Riller,PG,23,CHO,7,0,27,8,12,.667,2,4,.500,6,8,.750,.750,0,0,,0,1,1,3,1,0,1,0,18
2021,Austin Rivers,SG,28,TOT,36,7,845,104,245,.424,55,149,.369,49,96,.510,.537,22,31,.710,8,74,82,81,30,2,36,64,285
2021,Andre Roberson,SG,29,BRK,5,0,63,2,14,.143,1,8,.125,1,6,.167,.179,1,2,.500,7,8,15,4,3,1,2,4,6
2021,Duncan Robinson,SF,26,MIA,72,72,2262,315,717,.439,250,613,.408,65,104,.625,.614,62,75,.827,7,243,250,127,43,20,81,181,942
2021,Glenn Robinson III,SF,27,SAC,23,2,369,42,99,.424,16,44,.364,26,55,.473,.505,21,23,.913,11,34,45,20,4,3,11,23,121
2021,Jerome Robinson,SG,23,WAS,17,6,305,28,95,.295,11,42,.262,17,53,.321,.353,16,20,.800,4,34,38,25,12,6,19,31,83
2021,Justin Robinson,PG,23,OKC,9,0,88,7,21,.333,4,14,.286,3,7,.429,.429,3,5,.600,1,6,7,9,3,0,2,10,21
2021,Mitchell Robinson,C,22,NYK,31,29,853,115,176,.653,0,0,,115,176,.653,.653,26,53,.491,113,139,252,17,35,45,26,86,256
2021,Isaiah Roby,PF,22,OKC,61,34,1425,207,429,.483,32,109,.294,175,320,.547,.520,87,117,.744,89,252,341,107,52,37,113,162,533
2021,Rajon Rondo,PG,34,TOT,45,3,770,95,215,.442,36,89,.404,59,126,.468,.526,16,17,.941,18,92,110,199,37,4,79,53,242
2021,Derrick Rose,PG,32,TOT,50,3,1279,287,611,.470,50,129,.388,237,482,.492,.511,110,127,.866,20,110,130,209,49,19,78,56,734
2021,Terrence Ross,SG,29,ORL,46,2,1347,254,616,.412,89,264,.337,165,352,.469,.485,120,138,.870,15,143,158,108,47,21,74,88,717
2021,Terry Rozier,SG,26,CHO,69,69,2383,510,1134,.450,222,571,.389,288,563,.512,.548,165,202,.817,47,255,302,293,87,26,128,119,1407
2021,Ricky Rubio,PG,30,MIN,68,51,1772,193,498,.388,66,214,.308,127,284,.447,.454,130,150,.867,28,195,223,433,98,4,111,139,582
2021,D'Angelo Russell,PG,24,MIN,42,26,1196,281,652,.431,120,310,.387,161,342,.471,.523,114,149,.765,16,95,111,244,45,18,112,68,796
2021,Domantas Sabonis,PF,24,IND,62,62,2231,484,904,.535,52,162,.321,432,742,.582,.564,240,328,.732,150,592,742,415,76,33,213,203,1260
2021,Luka Šamanić,PF,21,SAS,33,4,308,47,105,.448,12,43,.279,35,62,.565,.505,16,29,.552,16,52,68,15,8,8,20,43,122
2021,JaKarr Sampson,PF,27,IND,29,4,316,56,113,.496,3,15,.200,53,98,.541,.509,19,29,.655,27,50,77,4,2,14,15,52,134
2021,Dario Šarić,C,26,PHO,50,4,871,153,342,.447,47,135,.348,106,207,.512,.516,84,99,.848,46,144,190,65,30,4,57,95,437
2021,Tomáš Satoranský,SG,29,CHI,58,18,1307,169,329,.514,42,118,.356,127,211,.602,.578,67,79,.848,30,112,142,271,40,14,96,89,447
2021,Dennis Schröder,SG,27,LAL,61,61,1956,332,760,.437,71,212,.335,261,548,.476,.484,206,243,.848,30,181,211,351,70,13,163,159,941
2021,Mike Scott,PF,32,PHI,51,12,852,76,211,.360,53,155,.342,23,56,.411,.486,8,12,.667,11,109,120,40,24,14,19,72,213
2021,Jay Scrubb,SG,20,LAC,4,1,84,14,36,.389,2,9,.222,12,27,.444,.417,5,5,1.000,2,12,14,1,4,0,7,5,35
2021,Collin Sexton,SG,22,CLE,60,60,2115,525,1105,.475,98,264,.371,427,841,.508,.519,312,383,.815,58,129,187,262,62,10,167,157,1460
2021,Landry Shamet,SG,23,BRK,61,12,1403,186,456,.408,129,333,.387,57,123,.463,.549,66,78,.846,11,101,112,99,31,10,48,93,567
2021,Iman Shumpert,SG,30,BRK,2,0,11,1,4,.250,0,3,.000,1,1,1.000,.250,0,0,,1,0,1,0,1,0,1,0,2
2021,Pascal Siakam,PF,26,TOR,56,56,2006,437,961,.455,73,246,.297,364,715,.509,.493,249,301,.827,95,310,405,250,64,37,130,174,1196
2021,Chris Silva,PF,24,TOT,15,0,92,10,16,.625,1,1,1.000,9,15,.600,.656,11,15,.733,7,20,27,6,1,6,10,24,32
2021,Ben Simmons,PG,24,PHI,58,58,1877,325,583,.557,3,10,.300,322,573,.562,.560,176,287,.613,93,324,417,401,93,35,173,171,829
2021,Anfernee Simons,SG,21,POR,64,0,1104,168,401,.419,120,282,.426,48,119,.403,.569,46,57,.807,14,126,140,89,18,8,43,96,502
2021,Deividas Sirvydis,SG,20,DET,20,0,133,14,40,.350,10,28,.357,4,12,.333,.475,3,6,.500,0,29,29,5,2,0,5,9,41
2021,Alen Smailagić,PF,20,GSW,15,1,84,11,27,.407,4,10,.400,7,17,.412,.481,2,6,.333,6,10,16,4,3,5,5,11,28
2021,Marcus Smart,PG,26,BOS,48,45,1581,203,510,.398,93,282,.330,110,228,.482,.489,128,162,.790,36,131,167,273,72,23,96,126,627
2021,Dennis Smith Jr.,PG,23,TOT,23,9,420,58,145,.400,19,58,.328,39,87,.448,.466,19,26,.731,12,43,55,77,23,14,26,37,154
2021,Ish Smith,PG,32,WAS,44,1,924,129,297,.434,18,49,.367,111,248,.448,.465,19,33,.576,22,128,150,172,32,13,41,62,295
2021,Jalen Smith,PF,20,PHO,27,1,156,22,50,.440,4,17,.235,18,33,.545,.480,5,7,.714,7,30,37,4,1,5,7,16,53
2021,Tony Snell,SG,29,ATL,47,23,992,88,171,.515,62,109,.569,26,62,.419,.696,11,11,1.000,18,94,112,59,13,11,21,75,249
2021,Ray Spalding,C,23,HOU,2,0,19,2,4,.500,0,1,.000,2,3,.667,.500,0,2,.000,2,2,4,0,0,2,3,3,4
2021,Cassius Stanley,SG,21,IND,24,0,93,13,43,.302,3,13,.231,10,30,.333,.337,7,9,.778,8,12,20,1,1,2,1,14,36
2021,Lamar Stevens,PF,23,CLE,40,0,499,62,136,.456,4,25,.160,58,111,.523,.471,37,51,.725,24,72,96,25,17,13,23,53,165
2021,Isaiah Stewart,C,19,DET,68,14,1455,226,409,.553,21,63,.333,205,346,.592,.578,64,92,.696,159,294,453,59,39,86,67,184,537
2021,Max Strus,SF,24,MIA,39,0,507,85,187,.455,50,148,.338,35,39,.897,.588,16,24,.667,5,36,41,24,11,2,8,43,236
2021,Edmond Sumner,SG,25,IND,53,24,861,148,282,.525,35,88,.398,113,194,.582,.587,68,83,.819,18,76,94,49,33,10,51,88,399
2021,Jae'Sean Tate,SF,25,HOU,70,58,2043,316,625,.506,60,195,.308,256,430,.595,.554,102,147,.694,132,242,374,178,85,36,98,222,794
2021,Jayson Tatum,SF,22,BOS,64,64,2290,605,1318,.459,187,485,.386,418,833,.502,.530,295,340,.868,50,422,472,276,75,31,171,122,1692
2021,Jeff Teague,PG,32,TOT,55,7,950,123,284,.433,36,82,.439,87,202,.431,.496,89,105,.848,15,73,88,132,34,12,64,56,371
2021,Garrett Temple,SG,34,CHI,56,25,1528,158,381,.415,67,200,.335,91,181,.503,.503,40,50,.800,29,131,160,124,43,30,58,126,423
2021,Tyrell Terry,PG,20,DAL,11,0,56,5,16,.313,0,7,.000,5,9,.556,.313,1,3,.333,0,6,6,6,5,0,2,2,11
2021,Daniel Theis,C,28,TOT,65,51,1601,252,466,.541,49,152,.322,203,314,.646,.593,74,110,.673,93,263,356,108,41,57,66,167,627
2021,Brodric Thomas,SG,24,TOT,32,1,399,39,108,.361,16,59,.271,23,49,.469,.435,31,46,.674,8,45,53,30,15,10,22,40,125
2021,Isaiah Thomas,PG,31,NOP,3,0,48,9,27,.333,3,12,.250,6,15,.400,.389,2,2,1.000,1,3,4,5,1,0,6,3,23
2021,Khyri Thomas,SG,24,HOU,5,2,153,32,66,.485,9,27,.333,23,39,.590,.553,9,9,1.000,7,11,18,25,9,6,6,8,82
2021,Matt Thomas,SG,26,TOT,45,0,326,50,127,.394,27,80,.338,23,47,.489,.500,12,14,.857,7,37,44,19,4,0,14,18,139
2021,Tristan Thompson,PF,29,BOS,54,43,1287,169,326,.518,0,3,.000,169,323,.523,.518,71,120,.592,169,270,439,67,24,33,62,119,409
2021,Sindarius Thornwell,SG,26,TOT,21,1,217,15,46,.326,7,23,.304,8,23,.348,.402,4,8,.500,3,15,18,21,13,2,7,15,41
2021,Matisse Thybulle,SG,23,PHI,65,8,1298,102,243,.420,43,143,.301,59,100,.590,.508,8,18,.444,30,94,124,63,105,71,32,127,255
2021,Killian Tillie,C,22,MEM,18,1,182,19,57,.333,10,33,.303,9,24,.375,.421,9,11,.818,6,18,24,8,5,8,2,20,57
2021,Xavier Tillman Sr.,PF,22,MEM,59,12,1085,167,299,.559,22,65,.338,145,234,.620,.595,34,53,.642,74,182,256,75,44,33,45,116,390
2021,Anthony Tolliver,PF,35,PHI,11,0,99,4,17,.235,4,14,.286,0,3,.000,.353,5,6,.833,3,7,10,2,3,2,3,7,17
2021,Obi Toppin,PF,22,NYK,62,0,683,104,209,.498,26,85,.306,78,124,.629,.560,19,26,.731,26,112,138,29,17,15,23,55,253
2021,Juan Toscano-Anderson,SG,27,GSW,53,16,1107,121,209,.579,37,92,.402,84,117,.718,.667,22,31,.710,29,205,234,150,41,26,61,111,301
2021,Axel Toupane,SF,28,MIL,8,1,61,4,11,.364,1,2,.500,3,9,.333,.409,5,7,.714,0,6,6,4,2,3,0,6,14
2021,Karl-Anthony Towns,C,25,MIN,50,50,1689,425,875,.486,122,315,.387,303,560,.541,.555,267,311,.859,133,396,529,225,39,57,160,186,1239
2021,Gary Trent Jr.,SG,22,TOT,58,38,1802,320,785,.408,165,429,.385,155,356,.435,.513,83,106,.783,27,125,152,80,56,10,43,92,888
2021,P.J. Tucker,PF,35,TOT,52,33,1356,66,177,.373,40,119,.336,26,58,.448,.486,21,28,.750,51,153,204,61,39,20,40,125,193
2021,Rayjon Tucker,PG,23,PHI,14,0,68,9,18,.500,2,7,.286,7,11,.636,.556,14,19,.737,1,10,11,6,2,0,4,8,34
2021,Myles Turner,C,24,IND,47,47,1455,206,432,.477,69,206,.335,137,226,.606,.557,111,142,.782,63,243,306,48,40,159,67,165,592
2021,Jonas Valančiūnas,C,28,MEM,62,61,1755,440,743,.592,21,57,.368,419,686,.611,.606,157,203,.773,253,523,776,112,35,57,100,179,1058
2021,Denzel Valentine,SG,27,CHI,62,3,1036,155,416,.373,80,242,.331,75,174,.431,.469,16,17,.941,24,173,197,105,30,7,42,70,406
2021,Jarred Vanderbilt,PF,21,MIN,64,30,1139,143,236,.606,1,5,.200,142,231,.615,.608,57,102,.559,118,250,368,76,64,46,53,123,344
2021,Fred VanVleet,SG,26,TOR,52,52,1899,338,870,.389,174,476,.366,164,394,.416,.489,169,191,.885,32,188,220,328,87,37,95,119,1019
2021,Anderson Varejão,C,38,CLE,5,0,36,4,16,.250,0,1,.000,4,15,.267,.250,5,9,.556,7,13,20,3,0,2,1,3,13
2021,Devin Vassell,SF,20,SAS,62,7,1056,123,303,.406,52,150,.347,71,153,.464,.492,43,51,.843,24,150,174,56,43,18,22,88,341
2021,Gabe Vincent,PG,24,MIA,50,7,655,88,233,.378,46,149,.309,42,84,.500,.476,20,23,.870,10,46,56,67,21,2,34,79,242
2021,Noah Vonleh,PF,25,BRK,4,0,11,0,3,.000,0,2,.000,0,1,.000,.000,0,0,,0,1,1,1,0,0,2,2,0
2021,Nikola Vučević,C,30,TOT,70,70,2348,666,1396,.477,176,440,.400,490,956,.513,.540,131,156,.840,146,671,817,269,65,48,126,137,1639
2021,Dean Wade,PF,24,CLE,63,19,1212,134,311,.431,78,213,.366,56,98,.571,.556,30,39,.769,38,177,215,74,35,21,30,78,376
2021,Moritz Wagner,C,23,TOT,45,24,722,104,229,.454,31,91,.341,73,138,.529,.522,71,87,.816,27,119,146,50,26,18,43,108,310
2021,Kemba Walker,PG,30,BOS,43,43,1369,284,676,.420,127,353,.360,157,323,.486,.514,134,149,.899,16,154,170,212,48,12,88,61,829
2021,Lonnie Walker IV,SG,22,SAS,60,38,1522,256,609,.420,100,282,.355,156,327,.477,.502,57,70,.814,14,141,155,101,29,15,65,101,669
2021,John Wall,PG,30,HOU,40,40,1288,293,726,.404,79,249,.317,214,477,.449,.458,158,211,.749,17,112,129,275,42,31,141,46,823
2021,Brad Wanamaker,PG,31,TOT,61,0,1053,115,299,.385,16,85,.188,99,214,.463,.411,90,101,.891,18,87,105,174,43,11,71,94,336
2021,T.J. Warren,SF,27,IND,4,4,117,27,51,.529,0,7,.000,27,44,.614,.529,8,10,.800,2,12,14,5,2,0,4,16,62
2021,P.J. Washington,PF,22,CHO,64,61,1954,302,686,.440,112,290,.386,190,396,.480,.522,108,145,.745,93,325,418,161,69,79,128,171,824
2021,Yuta Watanabe,SF,26,TOR,50,4,723,79,180,.439,36,90,.400,43,90,.478,.539,24,29,.828,36,123,159,40,26,19,19,57,218
2021,Tremont Waters,PG,23,BOS,26,3,238,34,84,.405,15,38,.395,19,46,.413,.494,16,17,.941,5,16,21,62,15,1,27,17,99
2021,Paul Watson,SF,26,TOR,27,2,297,38,82,.463,30,64,.469,8,18,.444,.646,5,8,.625,4,41,45,17,6,3,9,36,111
2021,Quinndary Weatherspoon,SG,24,SAS,20,0,121,16,35,.457,1,6,.167,15,29,.517,.471,13,16,.813,3,8,11,8,8,2,10,18,46
2021,Russell Westbrook,PG,32,WAS,65,65,2369,544,1238,.439,86,273,.315,458,965,.475,.474,271,413,.656,109,641,750,763,89,23,312,190,1445
2021,Coby White,PG,20,CHI,69,54,2156,375,902,.416,163,454,.359,212,448,.473,.506,128,142,.901,28,256,284,328,38,15,156,179,1041
2021,Derrick White,SG,26,SAS,36,32,1064,186,453,.411,84,243,.346,102,210,.486,.503,97,114,.851,13,94,107,127,26,36,45,91,553
2021,Hassan Whiteside,C,31,SAC,36,4,546,126,224,.563,0,1,.000,126,223,.565,.563,41,79,.519,61,154,215,20,9,46,40,73,293
2021,Greg Whittington,PF,27,DEN,4,0,12,0,3,.000,0,2,.000,0,1,.000,.000,0,0,,0,0,0,0,0,0,0,0,0
2021,Andrew Wiggins,PF,25,GSW,71,71,2364,505,1058,.477,140,368,.380,365,690,.529,.543,170,238,.714,82,265,347,167,67,70,126,159,1320
2021,Grant Williams,PF,22,BOS,63,9,1138,108,247,.437,48,129,.372,60,118,.508,.534,30,51,.588,48,130,178,64,32,24,56,161,294
2021,Kenrich Williams,PF,26,OKC,66,13,1426,219,411,.533,52,117,.444,167,294,.568,.596,36,63,.571,84,189,273,152,55,17,76,143,526
2021,Lou Williams,PG,34,TOT,66,4,1423,265,646,.410,69,173,.399,196,473,.414,.464,150,173,.867,21,117,138,225,47,6,108,62,749
2021,Patrick Williams,PF,19,CHI,71,71,1983,255,528,.483,54,138,.391,201,390,.515,.534,91,125,.728,66,261,327,99,64,46,98,126,655
2021,Robert Williams,C,23,BOS,52,13,985,186,258,.721,0,2,.000,186,256,.727,.721,45,73,.616,133,225,358,94,43,91,52,105,417
2021,Zion Williamson,PF,20,NOP,61,61,2026,634,1037,.611,10,34,.294,624,1003,.622,.616,369,529,.698,167,274,441,226,57,39,167,135,1647
2021,D.J. Wilson,PF,24,TOT,35,1,433,68,168,.405,30,87,.345,38,81,.469,.494,17,25,.680,20,92,112,23,11,16,22,44,183
2021,Dylan Windler,SF,24,CLE,31,0,513,57,130,.438,26,77,.338,31,53,.585,.538,21,27,.778,20,87,107,33,19,12,32,37,161
2021,Justise Winslow,SF,24,MEM,26,1,507,74,210,.352,10,54,.185,64,156,.410,.376,20,35,.571,18,100,118,50,15,12,37,47,178
2021,Cassius Winston,PG,22,WAS,22,0,98,14,33,.424,8,17,.471,6,16,.375,.545,5,6,.833,0,9,9,12,2,1,5,8,41
2021,James Wiseman,C,19,GSW,39,27,836,191,368,.519,12,38,.316,179,330,.542,.535,54,86,.628,55,171,226,26,11,36,60,121,448
2021,Christian Wood,C,25,HOU,41,41,1326,329,640,.514,77,206,.374,252,434,.581,.574,125,198,.631,76,319,395,71,34,48,80,88,860
2021,Robert Woodard II,SF,21,SAC,13,0,45,8,20,.400,1,6,.167,7,14,.500,.425,3,8,.375,4,12,16,2,0,3,1,4,20
2021,Delon Wright,SG-PG,28,TOT,63,39,1748,240,518,.463,64,172,.372,176,346,.509,.525,101,126,.802,65,204,269,278,101,30,83,75,645
2021,Thaddeus Young,PF,32,CHI,68,23,1652,370,662,.559,12,45,.267,358,617,.580,.568,71,113,.628,168,255,423,291,74,40,137,152,823
2021,Trae Young,PG,22,ATL,63,63,2125,487,1112,.438,136,397,.343,351,715,.491,.499,484,546,.886,38,207,245,594,53,12,261,111,1594
2021,Cody Zeller,C,28,CHO,48,21,1005,181,324,.559,4,28,.143,177,296,.598,.565,85,119,.714,119,209,328,86,27,17,51,121,451
2021,Ivica Zubac,C,23,LAC,72,33,1609,257,394,.652,1,4,.250,256,390,.656,.654,135,171,.789,189,330,519,90,24,62,81,187,650
2022,Precious Achiuwa,C,22,TOR,35,20,876,115,279,.412,10,43,.233,105,236,.445,.430,32,56,.571,82,181,263,43,20,22,36,76,272
2022,Steven Adams,C,28,MEM,45,44,1162,114,221,.516,0,0,,114,221,.516,.516,72,126,.571,192,227,419,135,44,26,69,75,300
2022,Bam Adebayo,C,24,MIA,22,22,723,151,290,.521,0,1,.000,151,289,.522,.521,104,135,.770,56,161,217,73,28,12,66,71,406
2022,Santi Aldama,PF,21,MEM,26,0,275,37,97,.381,4,39,.103,33,58,.569,.402,12,20,.600,23,40,63,14,2,7,8,25,90
2022,LaMarcus Aldridge,C,36,BRK,33,10,757,193,339,.569,12,36,.333,181,303,.597,.587,50,58,.862,50,133,183,30,12,36,29,59,448
2022,Nickeil Alexander-Walker,SG,23,NOP,43,18,1148,203,551,.368,82,267,.307,121,284,.426,.443,56,77,.727,34,110,144,114,36,14,67,76,544
2022,Grayson Allen,SG,26,MIL,41,40,1152,167,395,.423,107,274,.391,60,121,.496,.558,42,49,.857,19,119,138,55,34,15,26,62,483
2022,Jarrett Allen,C,23,CLE,40,40,1309,266,383,.695,1,8,.125,265,375,.707,.696,117,171,.684,136,303,439,75,33,56,76,72,650
2022,Jose Alvarado,PG,23,NOP,19,0,178,21,59,.356,7,28,.250,14,31,.452,.415,10,15,.667,6,12,18,29,19,1,4,20,59
2022,Justin Anderson,SF,28,TOT,6,0,77,6,19,.316,3,15,.200,3,4,.750,.395,6,7,.857,2,8,10,9,2,1,3,9,21
2022,Kyle Anderson,PF,28,MEM,38,8,853,123,282,.436,26,74,.351,97,208,.466,.482,39,59,.661,35,166,201,99,42,23,41,57,311
2022,Giannis Antetokounmpo,PF,27,MIL,39,39,1276,387,729,.531,42,149,.282,345,580,.595,.560,300,420,.714,71,369,440,235,40,58,136,128,1116
2022,Thanasis Antetokounmpo,SF,29,MIL,28,5,332,38,82,.463,1,11,.091,37,71,.521,.470,15,24,.625,30,47,77,19,13,7,17,54,92
2022,Carmelo Anthony,PF,37,LAL,44,3,1180,201,464,.433,102,262,.389,99,202,.490,.543,85,104,.817,38,145,183,42,31,35,36,102,589
2022,Cole Anthony,PG,21,ORL,34,34,1127,210,533,.394,79,240,.329,131,293,.447,.468,113,136,.831,20,184,204,196,27,10,93,91,612
2022,OG Anunoby,SF,24,TOR,29,29,1064,199,464,.429,72,212,.340,127,252,.504,.506,70,91,.769,44,111,155,70,48,14,50,88,540
2022,Trevor Ariza,SF,36,LAL,13,6,245,15,45,.333,12,38,.316,3,7,.429,.467,2,4,.500,4,40,44,15,6,2,7,7,44
2022,D.J. Augustin,PG,34,HOU,33,2,495,55,133,.414,39,94,.415,16,39,.410,.560,33,38,.868,6,34,40,73,10,0,43,17,182
2022,Deni Avdija,SF,21,WAS,47,6,1064,127,286,.444,40,131,.305,87,155,.561,.514,49,67,.731,33,190,223,76,37,30,41,106,343
2022,Joel Ayayi,SG,21,WAS,7,0,20,1,6,.167,0,1,.000,1,5,.200,.167,0,0,,1,2,3,4,0,0,0,0,2
2022,Deandre Ayton,C,23,PHO,28,28,837,205,322,.637,2,8,.250,203,314,.646,.640,57,80,.713,79,217,296,43,22,23,48,62,469
2022,Udoka Azubuike,C,22,UTA,8,1,54,5,8,.625,0,0,,5,8,.625,.625,1,2,.500,2,10,12,0,1,4,5,5,11
2022,Marvin Bagley III,PF,22,SAC,27,14,593,104,225,.462,14,57,.246,90,168,.536,.493,35,47,.745,63,133,196,16,8,9,18,45,257
2022,LaMelo Ball,PG,20,CHO,40,40,1273,275,661,.416,105,291,.361,170,370,.459,.495,105,118,.890,68,224,292,305,62,18,124,121,760
2022,Lonzo Ball,PG,24,CHI,35,35,1212,162,383,.423,110,260,.423,52,123,.423,.567,21,28,.750,35,155,190,178,64,31,82,85,455
2022,Mo Bamba,C,23,ORL,37,35,998,149,324,.460,50,141,.355,99,183,.541,.537,28,36,.778,81,219,300,54,27,77,51,101,376
2022,Desmond Bane,SF,23,MEM,45,45,1346,302,643,.470,131,312,.420,171,331,.517,.572,62,70,.886,23,176,199,108,49,21,68,110,797
2022,Dalano Banton,SF,22,TOR,34,1,398,50,122,.410,8,28,.286,42,94,.447,.443,18,24,.750,20,51,71,57,14,5,37,42,126
2022,Cat Barber,PG,27,ATL,3,0,13,0,4,.000,0,0,,0,4,.000,.000,0,4,.000,1,2,3,3,0,0,1,1,0
2022,Harrison Barnes,PF,29,SAC,43,43,1443,220,481,.457,89,213,.418,131,268,.489,.550,183,221,.828,47,211,258,102,30,9,70,54,712
2022,Scottie Barnes,PF,20,TOR,37,37,1311,217,463,.469,30,98,.306,187,365,.512,.501,77,107,.720,103,186,289,127,38,32,69,107,541
2022,RJ Barrett,SF,21,NYK,41,41,1336,255,609,.419,79,223,.354,176,386,.456,.484,123,179,.687,33,207,240,105,22,13,79,84,712
2022,Will Barton,SG,31,DEN,40,40,1306,232,535,.434,94,254,.370,138,281,.491,.521,52,66,.788,24,168,192,168,33,18,72,57,610
2022,Paris Bass,SF,26,PHO,2,0,7,2,6,.333,0,2,.000,2,4,.500,.333,2,2,1.000,2,2,4,0,1,0,2,2,6
2022,Charles Bassey,PF,21,PHI,21,0,152,27,40,.675,0,4,.000,27,36,.750,.675,8,11,.727,19,37,56,7,4,15,7,29,62
2022,Keita Bates-Diop,SF,26,SAS,39,12,673,88,178,.494,13,41,.317,75,137,.547,.531,29,42,.690,46,119,165,25,17,13,29,40,218
2022,Nicolas Batum,PF,33,LAC,28,24,729,93,189,.492,57,140,.407,36,49,.735,.643,15,22,.682,12,119,131,46,30,22,25,42,258
2022,Kent Bazemore,SF,32,LAL,25,14,416,35,106,.330,20,57,.351,15,49,.306,.425,10,13,.769,8,42,50,22,20,6,10,53,100
2022,Darius Bazley,PF,21,OKC,42,29,1080,137,353,.388,38,146,.260,99,207,.478,.442,57,83,.687,44,220,264,48,30,49,56,42,369
2022,Bradley Beal,SG,28,WAS,38,38,1364,338,745,.454,61,204,.299,277,541,.512,.495,159,190,.837,37,141,178,247,34,14,128,89,896
2022,Malik Beasley,SG,25,MIN,46,9,1226,201,537,.374,136,390,.349,65,147,.442,.501,21,29,.724,18,125,143,74,25,6,33,56,559
2022,Jordan Bell,C,27,CHI,1,0,2,0,0,,0,0,,0,0,,,0,0,,1,0,1,0,1,0,0,2,0
2022,DeAndre' Bembry,SF,27,BRK,40,16,769,95,164,.579,12,28,.429,83,136,.610,.616,17,29,.586,28,97,125,48,41,21,25,81,219
2022,Dāvis Bertāns,PF,29,WAS,32,0,488,59,168,.351,46,142,.324,13,26,.500,.488,27,29,.931,6,55,61,15,11,6,13,52,191
2022,Patrick Beverley,PG,33,MIN,32,28,834,99,243,.407,39,125,.312,60,118,.508,.488,42,61,.689,38,106,144,161,37,29,37,91,279
2022,Saddiq Bey,SF,22,DET,46,46,1540,240,629,.382,111,333,.333,129,296,.436,.470,103,123,.837,59,214,273,114,41,8,66,81,694
2022,Khem Birch,C,29,TOR,23,7,483,51,103,.495,0,8,.000,51,95,.537,.495,31,42,.738,61,58,119,28,19,11,16,39,133
2022,Goga Bitadze,C,22,IND,28,3,292,43,104,.413,6,38,.158,37,66,.561,.442,26,41,.634,37,43,80,15,10,17,16,45,118
2022,Bismack Biyombo,C,29,PHO,9,0,193,40,57,.702,0,0,,40,57,.702,.702,17,30,.567,29,39,68,12,7,11,8,20,97
2022,Nemanja Bjelica,C,33,GSW,47,0,721,110,246,.447,40,116,.345,70,130,.538,.528,39,56,.696,40,148,188,80,29,17,53,74,299
2022,Eric Bledsoe,PG,32,LAC,48,29,1233,174,414,.420,46,142,.324,128,272,.471,.476,78,103,.757,26,136,162,200,62,17,106,72,472
2022,Keljin Blevins,SF,26,POR,6,0,36,4,11,.364,4,9,.444,0,2,.000,.545,0,2,.000,0,3,3,2,0,0,3,1,12
2022,Bogdan Bogdanović,SG,29,ATL,28,26,803,124,301,.412,62,175,.354,62,126,.492,.515,27,35,.771,9,96,105,72,20,6,27,53,337
2022,Bojan Bogdanović,PF,32,UTA,46,46,1417,284,608,.467,115,297,.387,169,311,.543,.562,151,176,.858,38,156,194,80,22,1,75,77,834
2022,Bol Bol,PF,22,DEN,13,0,81,15,27,.556,1,4,.250,14,23,.609,.574,2,3,.667,4,16,20,5,1,2,4,4,33
2022,Leandro Bolmaro,SF,21,MIN,24,2,186,9,32,.281,2,12,.167,7,20,.350,.313,8,9,.889,15,20,35,11,5,0,12,21,28
2022,Isaac Bonga,SF,22,TOR,12,0,63,3,13,.231,1,4,.250,2,9,.222,.269,4,6,.667,4,3,7,3,7,2,2,10,11
2022,Devin Booker,SG,25,PHO,39,39,1299,345,788,.438,102,270,.378,243,518,.469,.503,164,190,.863,34,176,210,171,39,15,99,99,956
2022,Brandon Boston Jr.,SG,20,LAC,31,0,510,76,214,.355,23,79,.291,53,135,.393,.409,40,47,.851,10,68,78,28,17,8,22,25,215
2022,Chris Boucher,PF,29,TOR,42,7,837,140,310,.452,35,126,.278,105,184,.571,.508,75,100,.750,93,157,250,14,28,43,29,83,390
2022,James Bouknight,SG,21,CHO,20,0,171,28,77,.364,11,32,.344,17,45,.378,.435,11,13,.846,14,15,29,17,2,0,8,15,78
2022,Avery Bradley,SG,31,LAL,39,34,932,103,242,.426,56,143,.392,47,99,.475,.541,12,14,.857,21,74,95,35,36,8,22,72,274
2022,Tony Bradley,C,24,CHI,33,7,397,52,92,.565,0,0,,52,92,.565,.565,13,17,.765,44,91,135,19,7,24,23,45,117
2022,Ignas Brazdeikis,SF,23,ORL,21,0,193,20,57,.351,8,28,.286,12,29,.414,.421,8,10,.800,8,22,30,15,5,1,6,22,56
2022,Mikal Bridges,SF,25,PHO,46,46,1568,222,439,.506,63,168,.375,159,271,.587,.577,48,56,.857,44,143,187,94,59,20,37,85,555
2022,Miles Bridges,PF,23,CHO,45,45,1620,343,708,.484,87,272,.320,256,436,.587,.546,130,169,.769,56,278,334,158,49,40,84,116,903
2022,Oshae Brissett,SF,23,IND,37,1,701,87,207,.420,32,95,.337,55,112,.491,.498,30,48,.625,46,105,151,26,20,13,26,52,236
2022,Malcolm Brogdon,PG,29,IND,28,28,934,184,411,.448,46,150,.307,138,261,.529,.504,105,122,.861,24,120,144,166,24,11,61,57,519
2022,Armoni Brooks,SG,23,HOU,36,8,638,86,237,.363,63,200,.315,23,37,.622,.496,16,19,.842,11,64,75,49,20,7,19,57,251
2022,Dillon Brooks,SF,26,MEM,21,20,587,145,340,.426,33,101,.327,112,239,.469,.475,64,72,.889,17,52,69,57,27,4,37,69,387
2022,Bruce Brown,SF,25,BRK,37,18,788,103,211,.488,10,34,.294,93,177,.525,.512,26,33,.788,48,113,161,42,40,19,25,98,242
2022,Charlie Brown Jr.,SG,24,TOT,12,2,157,9,35,.257,1,11,.091,8,24,.333,.271,7,8,.875,13,17,30,5,9,4,4,15,26
2022,Chaundee Brown Jr.,SG-SF,23,TOT,5,2,104,10,32,.313,6,18,.333,4,14,.286,.406,5,6,.833,1,15,16,4,2,0,1,7,31
2022,Greg Brown III,SF,20,POR,18,0,85,13,31,.419,0,6,.000,13,25,.520,.419,6,13,.462,8,14,22,5,2,4,6,11,32
2022,Jaylen Brown,SF,25,BOS,34,34,1180,293,650,.451,95,263,.361,198,387,.512,.524,130,166,.783,28,194,222,103,38,14,100,91,811
2022,Moses Brown,C,22,DAL,25,1,165,27,50,.540,0,0,,27,50,.540,.540,27,43,.628,16,43,59,0,3,8,14,28,81
2022,Sterling Brown,SG,26,DAL,36,3,513,51,128,.398,27,79,.342,24,49,.490,.504,10,11,.909,22,104,126,29,12,5,21,43,139
2022,Troy Brown Jr.,SF,22,CHI,35,3,580,60,146,.411,22,68,.324,38,78,.487,.486,17,22,.773,22,85,107,44,21,4,17,37,159
2022,Jalen Brunson,PG,25,DAL,46,28,1432,291,582,.500,44,134,.328,247,448,.551,.538,101,126,.802,26,148,174,252,44,2,78,85,727
2022,Thomas Bryant,C,24,WAS,6,0,86,17,37,.459,4,14,.286,13,23,.565,.514,5,9,.556,8,11,19,4,2,3,1,9,43
2022,Shaq Buchanan,PG,25,MEM,2,0,10,1,4,.250,0,2,.000,1,2,.500,.250,0,0,,1,1,2,2,1,0,2,1,2
2022,Reggie Bullock,SF,30,DAL,39,13,918,87,228,.382,54,171,.316,33,57,.579,.500,14,19,.737,16,105,121,44,15,5,19,51,242
2022,Trey Burke,PG,29,DAL,23,0,270,56,134,.418,17,52,.327,39,82,.476,.481,16,17,.941,2,21,23,42,9,0,16,22,145
2022,Alec Burks,SG,30,NYK,47,20,1285,159,416,.382,86,218,.394,73,198,.369,.486,124,148,.838,27,176,203,120,56,12,43,110,528
2022,Jared Butler,SG,21,UTA,21,1,131,23,61,.377,13,34,.382,10,27,.370,.484,6,9,.667,1,15,16,16,8,6,17,21,65
2022,Jimmy Butler,SF,32,MIA,29,29,971,207,434,.477,13,54,.241,194,380,.511,.492,193,219,.881,51,123,174,176,54,12,56,36,620
2022,Devontae Cacok,PF,25,SAS,7,0,58,14,21,.667,0,0,,14,21,.667,.667,0,0,,5,16,21,2,4,5,1,8,28
2022,Kentavious Caldwell-Pope,SG,28,WAS,44,44,1300,181,440,.411,89,240,.371,92,200,.460,.513,52,60,.867,21,137,158,79,49,18,59,79,503
2022,Facundo Campazzo,PG,30,DEN,44,4,960,95,248,.383,49,157,.312,46,91,.505,.482,47,58,.810,17,76,93,176,51,19,54,98,286
2022,Vlatko Čančar,PF,24,DEN,14,1,152,22,39,.564,7,12,.583,15,27,.556,.654,9,12,.750,6,17,23,13,2,3,8,13,60
2022,Clint Capela,C,27,ATL,38,37,1120,196,344,.570,0,1,.000,196,343,.571,.570,46,99,.465,152,333,485,54,31,55,22,93,438
2022,Vernon Carey Jr.,C,20,CHO,4,1,17,3,6,.500,0,0,,3,6,.500,.500,2,3,.667,3,2,5,0,1,0,1,1,8
2022,Jevon Carter,PG,26,BRK,35,1,395,34,113,.301,23,81,.284,11,32,.344,.403,3,4,.750,7,42,49,31,13,8,16,34,94
2022,Wendell Carter Jr.,C,22,ORL,39,38,1133,197,396,.497,50,146,.342,147,250,.588,.561,79,113,.699,80,312,392,102,27,28,64,105,523
2022,Alex Caruso,SG,27,CHI,28,9,775,78,182,.429,30,87,.345,48,95,.505,.511,48,59,.814,25,83,108,109,54,11,40,68,234
2022,Willie Cauley-Stein,C,28,DAL,18,2,177,16,35,.457,1,2,.500,15,33,.455,.471,1,2,.500,13,25,38,9,6,3,7,17,34
2022,Ahmad Caver,PG,25,IND,1,0,1,1,1,1.000,0,0,,1,1,1.000,1.000,0,0,,0,0,0,0,0,0,0,0,2
2022,Justin Champagnie,SF,20,TOR,27,0,241,28,59,.475,9,22,.409,19,37,.514,.551,9,9,1.000,36,25,61,8,7,4,6,31,74
2022,Zylan Cheatham,SF,26,UTA,1,0,5,0,3,.000,0,2,.000,0,1,.000,.000,0,0,,0,0,0,0,0,0,0,0,0
2022,Chris Chiozza,PG,26,GSW,23,1,246,16,57,.281,13,37,.351,3,20,.150,.395,1,1,1.000,8,19,27,39,8,0,21,22,46
2022,Marquese Chriss,PF,24,DAL,14,0,149,34,56,.607,6,14,.429,28,42,.667,.661,10,16,.625,10,38,48,4,2,4,11,33,84
2022,Josh Christopher,SG,20,HOU,39,2,620,100,218,.459,28,81,.346,72,137,.526,.523,40,50,.800,27,52,79,63,32,6,59,42,268
2022,Gary Clark,PF,27,NOP,14,1,147,14,38,.368,13,32,.406,1,6,.167,.539,2,4,.500,7,25,32,5,3,2,4,3,43
2022,Brandon Clarke,PF,25,MEM,34,1,625,143,220,.650,4,18,.222,139,202,.688,.659,42,62,.677,65,110,175,46,15,38,18,55,332
2022,Jordan Clarkson,SG,29,UTA,47,1,1237,263,658,.400,119,370,.322,144,288,.500,.490,74,92,.804,35,128,163,110,34,12,78,86,719
2022,Nic Claxton,C,22,BRK,20,14,443,80,122,.656,0,0,,80,122,.656,.656,24,39,.615,38,71,109,19,11,23,15,50,184
2022,Amir Coffey,SG,24,LAC,35,13,711,79,174,.454,42,110,.382,37,64,.578,.575,44,50,.880,14,87,101,56,17,8,13,41,244
2022,John Collins,PF,24,ATL,41,41,1318,261,486,.537,55,129,.426,206,357,.577,.594,118,148,.797,75,249,324,83,26,45,48,131,695
2022,Darren Collison,PG,34,LAL,3,0,37,2,7,.286,0,3,.000,2,4,.500,.286,0,0,,0,4,4,2,1,0,1,5,4
2022,Mike Conley,PG,34,UTA,42,42,1197,205,449,.457,103,243,.424,102,206,.495,.571,75,91,.824,24,102,126,217,46,11,67,72,588
2022,Pat Connaughton,SG,29,MIL,46,16,1270,173,366,.473,108,267,.404,65,99,.657,.620,30,37,.811,32,177,209,64,45,13,30,60,484
2022,Tyler Cook,PF,24,CHI,12,2,154,18,28,.643,0,0,,18,28,.643,.643,15,21,.714,12,30,42,3,4,3,6,22,51
2022,Sharife Cooper,PG,20,ATL,10,0,35,3,14,.214,1,6,.167,2,8,.250,.250,0,0,,0,5,5,5,0,0,5,1,7
2022,Petr Cornelie,PF,26,DEN,13,0,38,5,15,.333,1,8,.125,4,7,.571,.367,3,4,.750,7,7,14,3,1,1,4,7,14
2022,DeMarcus Cousins,C,31,TOT,18,5,299,56,125,.448,13,51,.255,43,74,.581,.500,31,40,.775,25,79,104,19,16,8,17,50,156
2022,Robert Covington,PF,31,POR,43,35,1254,118,299,.395,73,205,.356,45,94,.479,.517,22,28,.786,36,203,239,52,62,55,49,113,331
2022,Torrey Craig,SF,31,IND,43,6,794,101,214,.472,34,104,.327,67,110,.609,.551,24,29,.828,52,108,160,49,19,15,28,76,260
2022,Jae Crowder,PF,31,PHO,39,39,1096,125,306,.408,74,205,.361,51,101,.505,.529,37,46,.804,13,177,190,54,49,18,36,92,361
2022,Jarrett Culver,SG,22,MEM,22,0,224,36,86,.419,8,28,.286,28,58,.483,.465,9,19,.474,8,29,37,24,14,2,10,26,89
2022,Jarron Cumberland,SG,24,POR,3,0,12,1,2,.500,0,1,.000,1,1,1.000,.500,0,0,,1,2,3,1,0,0,0,2,2
2022,Cade Cunningham,PG,20,DET,37,37,1186,219,545,.402,76,236,.322,143,309,.463,.472,67,79,.848,32,167,199,192,47,23,134,109,581
2022,Seth Curry,SG,31,PHI,40,40,1392,239,470,.509,91,218,.417,148,252,.587,.605,64,73,.877,15,121,136,159,32,9,76,86,633
2022,Stephen Curry,PG,33,GSW,43,43,1494,360,866,.416,207,550,.376,153,316,.484,.535,189,207,.913,26,202,228,267,61,20,138,85,1116
2022,Anthony Davis,C,28,LAL,27,27,955,251,482,.521,10,56,.179,241,426,.566,.531,117,161,.727,74,193,267,77,32,55,60,63,629
2022,Ed Davis,C,32,CLE,14,3,131,9,14,.643,0,0,,9,14,.643,.643,3,8,.375,7,36,43,3,3,7,3,22,21
2022,Terence Davis,SG,24,SAC,29,10,527,111,262,.424,48,147,.327,63,115,.548,.515,34,41,.829,11,81,92,39,25,11,33,70,304
2022,Gabriel Deck,PF,26,OKC,7,0,56,8,14,.571,2,4,.500,6,10,.600,.643,0,0,,1,5,6,5,1,0,2,2,18
2022,Dewayne Dedmon,C,32,MIA,40,15,672,107,178,.601,12,21,.571,95,157,.605,.635,43,56,.768,75,172,247,31,16,20,41,89,269
2022,Sam Dekker,PF,27,TOR,1,0,1,0,0,,0,0,,0,0,,,0,0,,0,0,0,0,0,0,0,0,0
2022,Javin DeLaurier,C,23,MIL,1,0,3,0,0,,0,0,,0,0,,,0,0,,0,1,1,0,1,0,0,1,0
2022,DeMar DeRozan,PF,32,CHI,42,42,1463,398,804,.495,25,75,.333,373,729,.512,.511,284,332,.855,33,176,209,200,34,15,92,93,1105
2022,Mamadi Diakite,PF,25,OKC,7,0,82,10,20,.500,0,0,,10,20,.500,.500,0,2,.000,7,17,24,0,3,3,3,15,20
2022,Cheick Diallo,C,25,DET,3,0,31,3,8,.375,0,0,,3,8,.375,.375,5,6,.833,4,8,12,0,1,0,1,6,11
2022,Hamidou Diallo,SG,23,DET,39,22,879,174,341,.510,15,59,.254,159,282,.564,.532,55,86,.640,41,137,178,52,48,15,43,98,418
2022,Gorgui Dieng,C,32,ATL,32,3,309,39,84,.464,19,46,.413,20,38,.526,.577,17,23,.739,28,74,102,28,9,12,17,45,114
2022,Spencer Dinwiddie,PG,28,WAS,38,38,1160,171,436,.392,65,203,.320,106,233,.455,.467,105,129,.814,29,143,172,220,23,7,61,92,512
2022,Donte DiVincenzo,SG,25,MIL,10,0,189,18,67,.269,13,45,.289,5,22,.227,.366,19,21,.905,13,29,42,15,6,3,13,17,68
2022,Luka Dončić,PG,22,DAL,32,32,1126,294,673,.437,74,254,.291,220,419,.525,.492,156,208,.750,27,256,283,279,39,15,148,75,818
2022,Luguentz Dort,SF,22,OKC,43,43,1384,234,591,.396,104,318,.327,130,273,.476,.484,120,141,.851,29,142,171,69,36,16,66,127,692
2022,Ayo Dosunmu,SG,22,CHI,42,8,944,127,233,.545,37,82,.451,90,151,.596,.624,26,43,.605,16,91,107,81,22,17,48,83,317
2022,Damyean Dotson,SG,27,NYK,2,0,21,2,4,.500,0,1,.000,2,3,.667,.500,0,0,,0,2,2,1,0,0,0,0,4
2022,Devon Dotson,PG,22,CHI,11,0,85,11,23,.478,2,9,.222,9,14,.643,.522,5,9,.556,1,8,9,15,1,0,5,11,29
2022,Sekou Doumbouya,PF,21,LAL,2,0,16,5,8,.625,1,2,.500,4,6,.667,.688,3,4,.750,2,4,6,0,3,2,2,1,14
2022,Jeff Dowtin,PG,24,TOT,5,0,31,3,7,.429,0,2,.000,3,5,.600,.429,0,0,,1,6,7,3,0,1,1,2,6
2022,PJ Dozier,SG,25,DEN,18,0,340,36,99,.364,15,48,.313,21,51,.412,.439,10,13,.769,14,49,63,29,11,6,13,33,97
2022,Goran Dragić,PG,35,TOR,5,2,90,13,34,.382,4,14,.286,9,20,.450,.441,10,10,1.000,2,12,14,9,5,1,1,8,40
2022,Andre Drummond,C,28,PHI,41,11,759,108,203,.532,0,1,.000,108,202,.535,.532,41,79,.519,116,246,362,75,47,40,71,101,257
2022,Chris Duarte,SG,24,IND,40,28,1162,208,472,.441,73,205,.356,135,267,.506,.518,56,77,.727,28,137,165,91,45,7,66,70,545
2022,David Duke Jr.,PG,22,BRK,14,7,244,29,78,.372,7,25,.280,22,53,.415,.417,14,17,.824,27,30,57,13,7,6,8,28,79
2022,Kevin Durant,PF,33,BRK,36,36,1313,379,729,.520,67,180,.372,312,549,.568,.566,228,255,.894,20,247,267,207,28,34,107,68,1053
2022,Jaime Echenique,C,24,WAS,1,0,3,0,0,,0,0,,0,0,,,0,0,,0,0,0,0,0,0,0,0,0
2022,Anthony Edwards,SG,20,MIN,40,40,1401,323,729,.443,131,349,.375,192,380,.505,.533,112,139,.806,41,162,203,143,61,26,122,93,889
2022,Kessler Edwards,SF,21,BRK,15,8,387,50,109,.459,23,54,.426,27,55,.491,.564,1,1,1.000,18,45,63,12,14,10,15,32,124
2022,Rob Edwards,SG,25,OKC,2,0,11,1,4,.250,1,4,.250,0,0,,.375,0,0,,0,3,3,0,0,0,1,0,3
2022,CJ Elleby,SF,21,POR,26,0,283,36,83,.434,13,40,.325,23,43,.535,.512,13,16,.813,15,38,53,18,13,2,11,35,98
2022,Wayne Ellington,SG,34,LAL,31,8,614,66,165,.400,58,151,.384,8,14,.571,.576,4,5,.800,7,43,50,22,16,2,14,31,194
2022,Joel Embiid,C,27,PHI,35,35,1149,327,656,.498,46,118,.390,281,538,.522,.534,303,372,.815,70,304,374,149,35,48,102,90,1003
2022,James Ennis III,SF,31,TOT,7,0,56,11,24,.458,3,8,.375,8,16,.500,.521,4,5,.800,5,7,12,3,2,2,2,5,29
2022,Drew Eubanks,C,24,SAS,42,8,513,68,134,.507,1,6,.167,67,128,.523,.511,53,70,.757,50,115,165,41,12,26,41,54,190
2022,Tacko Fall,C,26,CLE,11,1,59,5,12,.417,0,0,,5,12,.417,.417,2,7,.286,7,16,23,2,0,6,3,3,12
2022,Derrick Favors,C,30,OKC,31,13,496,73,147,.497,2,12,.167,71,135,.526,.503,10,18,.556,45,100,145,24,12,7,6,47,158
2022,Bruno Fernando,C,23,BOS,14,0,38,4,6,.667,0,0,,4,6,.667,.667,2,3,.667,3,5,8,1,0,2,5,5,10
2022,Dorian Finney-Smith,PF,28,DAL,46,46,1479,175,394,.444,87,236,.369,88,158,.557,.555,36,55,.655,72,152,224,90,55,25,46,104,473
2022,Malik Fitts,PF,24,UTA,7,0,35,2,9,.222,2,4,.500,0,5,.000,.333,0,0,,0,10,10,0,0,0,2,3,6
2022,Malachi Flynn,PG,23,TOR,27,1,231,30,86,.349,12,44,.273,18,42,.429,.419,4,7,.571,6,22,28,25,10,3,8,23,76
2022,Bryn Forbes,SG,28,TOT,42,1,716,136,318,.428,66,159,.415,70,159,.440,.531,46,51,.902,5,60,65,42,17,3,33,50,384
2022,Aleem Ford,SF,24,ORL,5,0,74,6,20,.300,2,15,.133,4,5,.800,.350,0,0,,2,13,15,2,1,0,4,7,14
2022,Trent Forrest,PG,23,UTA,37,3,374,33,61,.541,2,7,.286,31,54,.574,.557,19,25,.760,13,46,59,40,10,3,27,21,87
2022,Evan Fournier,SG,29,NYK,46,46,1326,226,541,.418,124,319,.389,102,222,.459,.532,47,64,.734,22,107,129,82,39,11,59,87,623
2022,De'Aaron Fox,PG,24,SAC,43,43,1468,338,738,.458,39,157,.248,299,581,.515,.484,189,254,.744,20,142,162,222,52,17,120,122,904
2022,Tim Frazier,PG,31,ORL,10,3,200,13,43,.302,6,17,.353,7,26,.269,.372,5,9,.556,5,14,19,33,3,1,13,24,37
2022,Enes Freedom,C,29,BOS,31,1,383,48,88,.545,1,4,.250,47,84,.560,.551,22,26,.846,57,86,143,6,5,14,17,38,119
2022,Wenyen Gabriel,PF,24,TOT,7,0,47,5,13,.385,2,5,.400,3,8,.375,.462,2,4,.500,5,10,15,2,1,2,3,11,14
2022,Daniel Gafford,C,23,WAS,44,44,941,171,247,.692,0,0,,171,247,.692,.692,59,80,.738,98,175,273,44,18,71,41,104,401
2022,Danilo Gallinari,PF,33,ATL,36,1,831,120,287,.418,60,150,.400,60,137,.438,.523,76,82,.927,20,135,155,52,15,7,23,52,376
2022,Langston Galloway,SG,30,TOT,7,0,107,6,26,.231,2,16,.125,4,10,.400,.269,0,0,,3,15,18,12,1,0,6,7,14
2022,Darius Garland,PG,22,CLE,42,42,1464,314,676,.464,103,286,.360,211,390,.541,.541,95,104,.913,23,116,139,344,53,4,157,74,826
2022,Marcus Garrett,SG,23,MIA,12,0,128,5,21,.238,1,4,.250,4,17,.235,.262,2,5,.400,9,14,23,7,5,3,2,16,13
2022,Usman Garuba,PF,19,HOU,15,0,105,8,24,.333,2,13,.154,6,11,.545,.375,1,2,.500,9,25,34,8,7,6,3,9,19
2022,Luka Garza,C,23,DET,27,5,327,51,117,.436,13,40,.325,38,77,.494,.491,27,42,.643,47,36,83,15,8,4,16,46,142
2022,Rudy Gay,PF,35,UTA,30,1,609,95,225,.422,47,128,.367,48,97,.495,.527,43,51,.843,29,111,140,32,17,9,23,57,280
2022,Paul George,SF,31,LAC,26,26,924,234,556,.421,70,217,.323,164,339,.484,.484,103,117,.880,11,174,185,142,53,10,109,65,641
2022,Taj Gibson,C,36,NYK,31,3,579,44,88,.500,4,15,.267,40,73,.548,.523,21,29,.724,51,90,141,21,14,26,22,84,113
2022,Josh Giddey,SG,19,OKC,42,42,1294,201,497,.404,45,169,.266,156,328,.476,.450,35,53,.660,72,240,312,259,41,18,124,71,482
2022,Shai Gilgeous-Alexander,PG,23,OKC,42,42,1470,330,778,.424,67,238,.282,263,540,.487,.467,239,291,.821,30,171,201,233,47,33,103,100,966
2022,Anthony Gill,PF,29,WAS,18,0,113,18,27,.667,5,7,.714,13,20,.650,.759,10,12,.833,8,17,25,8,1,2,5,19,51
2022,Freddie Gillespie,PF,24,ORL,9,2,119,9,22,.409,0,1,.000,9,21,.429,.409,3,7,.429,13,23,36,5,3,9,5,18,21
2022,Rudy Gobert,C,29,UTA,42,42,1364,237,335,.707,0,2,.000,237,333,.712,.707,196,284,.690,154,479,633,49,33,95,77,112,670
2022,Brandon Goodwin,PG,26,CLE,9,0,136,19,51,.373,4,15,.267,15,36,.417,.412,3,10,.300,6,15,21,29,9,0,6,11,45
2022,Jordan Goodwin,SG,23,WAS,2,0,6,0,3,.000,0,1,.000,0,2,.000,.000,0,0,,0,1,1,0,0,0,0,1,0
2022,Aaron Gordon,PF,26,DEN,42,42,1343,232,441,.526,46,135,.341,186,306,.608,.578,96,131,.733,71,164,235,106,28,24,73,81,606
2022,Eric Gordon,SG,33,HOU,40,29,1181,209,413,.506,94,208,.452,115,205,.561,.620,79,107,.738,9,68,77,128,22,16,84,42,591
2022,Devonte' Graham,PG,26,NOP,43,43,1349,200,539,.371,132,365,.362,68,174,.391,.494,72,87,.828,20,91,111,194,44,8,68,61,604
2022,Jerami Grant,PF,27,DET,24,24,797,158,382,.414,42,127,.331,116,255,.455,.469,124,146,.849,23,93,116,62,27,27,51,54,482
2022,Hassani Gravett,PG,25,ORL,8,3,171,18,38,.474,11,26,.423,7,12,.583,.618,3,4,.750,1,20,21,20,5,1,9,13,50
2022,Danny Green,SF,34,PHI,29,21,688,66,162,.407,53,139,.381,13,23,.565,.571,9,10,.900,16,59,75,32,38,25,26,51,194
2022,Draymond Green,PF,31,GSW,34,34,1018,108,201,.537,12,42,.286,96,159,.604,.567,40,67,.597,38,219,257,250,47,41,106,94,268
2022,Jalen Green,SG,19,HOU,32,32,955,155,407,.381,59,198,.298,96,209,.459,.453,92,111,.829,14,89,103,70,17,5,76,45,461
2022,JaMychal Green,PF,31,DEN,35,7,523,73,167,.437,19,76,.250,54,91,.593,.494,36,42,.857,31,97,128,28,24,17,32,76,201
2022,Javonte Green,SF,28,CHI,30,19,668,64,128,.500,12,33,.364,52,95,.547,.547,33,42,.786,44,81,125,29,26,13,17,62,173
2022,Jeff Green,C,35,DEN,41,29,1032,162,314,.516,34,99,.343,128,215,.595,.570,82,102,.804,22,110,132,53,13,21,42,96,440
2022,Josh Green,SG,21,DAL,32,0,389,53,96,.552,7,21,.333,46,75,.613,.589,14,21,.667,19,40,59,34,17,5,14,48,127
2022,Blake Griffin,PF,32,BRK,36,20,656,78,206,.379,20,96,.208,58,110,.527,.427,40,55,.727,40,118,158,74,18,11,16,71,216
2022,Quentin Grimes,SG,21,NYK,30,2,453,57,139,.410,45,111,.405,12,28,.429,.572,6,9,.667,11,33,44,29,16,5,17,40,165
2022,Kyle Guy,SG,24,MIA,9,0,137,23,48,.479,12,29,.414,11,19,.579,.604,4,5,.800,1,9,10,15,4,1,6,11,62
2022,Rui Hachimura,PF,23,WAS,8,0,128,23,56,.411,6,17,.353,17,39,.436,.464,12,16,.750,2,31,33,5,2,1,4,4,64
2022,Tyrese Haliburton,SG,21,SAC,44,44,1501,230,489,.470,93,213,.437,137,276,.496,.565,62,77,.805,33,140,173,316,72,31,98,64,615
2022,Tyler Hall,SG,24,NYK,1,0,2,0,0,,0,0,,0,0,,,0,0,,0,0,0,0,0,0,0,0,0
2022,R.J. Hampton,SG,20,ORL,42,1,815,107,280,.382,39,107,.364,68,173,.393,.452,48,79,.608,14,108,122,102,29,8,56,62,301
2022,Tim Hardaway Jr.,SG,29,DAL,41,20,1235,207,525,.394,101,301,.336,106,224,.473,.490,73,98,.745,13,143,156,91,38,6,34,74,588
2022,James Harden,PG,32,BRK,41,41,1515,273,652,.419,97,287,.338,176,365,.482,.493,288,332,.867,38,289,327,414,53,29,196,100,931
2022,Maurice Harkless,SF,28,SAC,30,14,551,47,106,.443,16,60,.267,31,46,.674,.519,10,15,.667,6,63,69,16,12,17,18,46,120
2022,Jared Harper,PG,24,NOP,2,0,10,3,7,.429,1,2,.500,2,5,.400,.500,0,0,,1,0,1,3,0,1,1,2,7
2022,Montrezl Harrell,C,28,WAS,40,3,983,216,331,.653,4,14,.286,212,317,.669,.659,131,178,.736,87,194,281,85,18,27,43,78,567
2022,Gary Harris,SG,27,ORL,40,30,1189,171,388,.441,69,194,.356,102,194,.526,.530,52,62,.839,28,63,91,72,34,8,48,78,463
2022,Joe Harris,SF,30,BRK,14,14,423,56,124,.452,41,88,.466,15,36,.417,.617,5,6,.833,5,51,56,14,7,2,16,31,158
2022,Tobias Harris,PF,29,PHI,37,37,1294,256,555,.461,42,134,.313,214,421,.508,.499,120,141,.851,42,232,274,141,24,22,60,77,674
2022,Shaquille Harrison,SG,28,BRK,2,0,23,2,6,.333,0,2,.000,2,4,.500,.333,0,0,,1,3,4,3,1,1,2,3,4
2022,Josh Hart,PF,26,NOP,37,36,1230,179,347,.516,38,114,.333,141,233,.605,.571,103,137,.752,50,230,280,157,36,11,73,111,499
2022,Isaiah Hartenstein,C,23,LAC,34,0,529,106,160,.663,2,3,.667,104,157,.662,.669,37,56,.661,56,88,144,60,26,40,31,84,251
2022,Udonis Haslem,C,41,MIA,8,0,52,10,20,.500,1,2,.500,9,18,.500,.525,3,3,1.000,4,13,17,2,1,1,2,11,24
2022,Sam Hauser,SF,24,BOS,7,0,31,3,11,.273,3,11,.273,0,0,,.409,0,0,,1,3,4,1,1,1,0,1,9
2022,Jaxson Hayes,C,21,NOP,34,0,479,87,149,.584,5,16,.313,82,133,.617,.601,60,80,.750,45,75,120,12,12,24,23,68,239
2022,Killian Hayes,PG,20,DET,34,33,867,77,221,.348,29,94,.309,48,127,.378,.414,28,33,.848,16,86,102,125,39,16,53,84,211
2022,Gordon Hayward,SF,31,CHO,45,45,1489,277,588,.471,83,209,.397,194,379,.512,.542,126,149,.846,36,176,212,168,43,22,76,80,763
2022,Aaron Henry,SF,22,PHI,6,0,17,1,5,.200,0,1,.000,1,4,.250,.200,0,0,,0,1,1,0,0,2,2,2,2
2022,Juancho Hernangómez,PF,26,TOT,19,0,98,5,27,.185,3,18,.167,2,9,.222,.241,6,9,.667,10,16,26,3,4,2,7,7,19
2022,Willy Hernangómez,C,27,NOP,22,3,342,70,125,.560,2,3,.667,68,122,.557,.568,36,51,.706,56,98,154,28,8,5,20,40,178
2022,Tyler Herro,SG,22,MIA,38,10,1250,290,675,.430,100,258,.388,190,417,.456,.504,106,121,.876,25,160,185,153,24,6,106,54,786
2022,Buddy Hield,SG,29,SAC,48,6,1395,241,616,.391,167,438,.381,74,178,.416,.527,78,90,.867,34,155,189,96,44,14,74,99,727
2022,Haywood Highsmith,SF,25,MIA,4,0,42,4,8,.500,4,7,.571,0,1,.000,.750,0,0,,2,3,5,0,0,1,0,3,12
2022,George Hill,SG,35,MIL,39,16,1006,100,227,.441,36,113,.319,64,114,.561,.520,46,48,.958,34,93,127,97,29,5,35,55,282
2022,Malcolm Hill,SF-SG,26,TOT,9,0,123,13,26,.500,6,16,.375,7,10,.700,.615,8,10,.800,7,9,16,4,5,1,1,17,40
2022,Solomon Hill,PF,30,ATL,13,1,139,3,20,.150,2,13,.154,1,7,.143,.200,0,0,,6,17,23,12,4,2,1,16,8
2022,Nate Hinton,SG,22,IND,2,0,2,0,1,.000,0,0,,0,1,.000,.000,0,0,,0,0,0,0,0,0,1,0,0
2022,Jaylen Hoard,SF,22,OKC,1,0,2,0,1,.000,0,0,,0,1,.000,.000,0,0,,1,1,2,0,0,0,0,0,0
2022,Aaron Holiday,PG,25,WAS,36,10,570,88,186,.473,21,56,.375,67,130,.515,.530,21,26,.808,7,52,59,67,19,8,32,55,218
2022,Jrue Holiday,PG,31,MIL,36,33,1174,262,531,.493,64,166,.386,198,365,.542,.554,66,89,.742,34,133,167,231,55,20,96,65,654
2022,Justin Holiday,SF,32,IND,42,33,1201,159,390,.408,108,291,.371,51,99,.515,.546,31,38,.816,15,102,117,72,29,15,40,91,457
2022,Richaun Holmes,C,28,SAC,30,30,773,158,224,.705,2,4,.500,156,220,.709,.710,53,67,.791,70,175,245,37,11,33,41,91,371
2022,Rodney Hood,SF,29,MIL,35,0,549,44,121,.364,24,76,.316,20,45,.444,.463,13,14,.929,12,53,65,29,11,3,7,26,125
2022,Scotty Hopson,SG,32,OKC,1,0,18,2,4,.500,0,1,.000,2,3,.667,.500,0,0,,0,1,1,1,0,0,2,1,4
2022,Al Horford,C,35,BOS,39,39,1136,156,351,.444,46,162,.284,110,189,.582,.510,56,65,.862,60,227,287,139,24,52,41,85,414
2022,Talen Horton-Tucker,SG,21,LAL,31,15,834,124,299,.415,25,99,.253,99,200,.495,.457,51,65,.785,20,88,108,83,29,15,48,83,324
2022,Danuel House Jr.,SF,28,TOT,22,2,344,36,100,.360,15,50,.300,21,50,.420,.435,24,30,.800,6,52,58,29,8,8,20,22,111
2022,Dwight Howard,C,36,LAL,37,11,551,69,112,.616,6,9,.667,63,103,.612,.643,47,74,.635,71,130,201,21,27,24,31,73,191
2022,Markus Howard,SG,22,DEN,17,0,118,23,64,.359,19,48,.396,4,16,.250,.508,7,8,.875,0,5,5,5,6,0,6,11,72
2022,Kevin Huerter,SG,23,ATL,39,25,1136,177,385,.460,71,194,.366,106,191,.555,.552,25,31,.806,17,116,133,113,20,11,52,78,450
2022,Jay Huff,C,23,LAL,4,0,20,0,3,.000,0,2,.000,0,1,.000,.000,0,0,,1,3,4,1,1,1,1,1,0
2022,Elijah Hughes,SF,23,UTA,11,1,76,12,24,.500,9,18,.500,3,6,.500,.688,3,3,1.000,0,11,11,5,3,0,5,5,36
2022,De'Andre Hunter,SF,24,ATL,18,17,528,90,196,.459,29,74,.392,61,122,.500,.533,28,40,.700,7,53,60,18,13,10,25,49,237
2022,Chandler Hutchison,SF,25,PHO,6,0,22,1,2,.500,0,0,,1,2,.500,.500,2,2,1.000,0,5,5,2,0,0,4,1,4
2022,Bones Hyland,PG,21,DEN,34,0,600,99,273,.363,58,171,.339,41,102,.402,.469,33,37,.892,7,78,85,57,17,9,36,71,289
2022,Serge Ibaka,C,32,LAC,29,8,447,74,159,.465,23,57,.404,51,102,.500,.538,14,22,.636,35,86,121,32,6,21,30,48,185
2022,Andre Iguodala,SF,38,GSW,25,0,513,39,101,.386,13,60,.217,26,41,.634,.450,13,16,.813,19,65,84,97,21,21,23,24,104
2022,Joe Ingles,SF,34,UTA,42,12,1063,112,271,.413,75,213,.352,37,58,.638,.552,15,20,.750,12,110,122,150,23,5,46,77,314
2022,Brandon Ingram,SF,24,NOP,36,36,1238,294,664,.443,58,168,.345,236,496,.476,.486,162,198,.818,28,191,219,188,22,12,95,72,808
2022,Kyrie Irving,PG,29,BRK,7,7,242,68,135,.504,15,41,.366,53,94,.564,.559,13,13,1.000,3,31,34,36,7,2,15,15,164
2022,Wes Iwundu,SF,27,ATL,3,1,82,8,18,.444,3,5,.600,5,13,.385,.528,3,4,.750,3,10,13,0,1,0,1,8,22
2022,Frank Jackson,PG,23,DET,33,5,749,123,305,.403,62,186,.333,61,119,.513,.505,44,53,.830,11,40,51,31,16,8,27,54,352
2022,Isaiah Jackson,PF,20,IND,15,0,108,18,40,.450,0,2,.000,18,38,.474,.450,13,21,.619,12,22,34,4,5,9,4,24,49
2022,Jaren Jackson Jr.,PF,22,MEM,48,48,1329,268,654,.410,83,265,.313,185,389,.476,.473,166,204,.814,64,209,273,50,48,104,86,164,785
2022,Josh Jackson,SF,24,DET,37,3,685,103,248,.415,30,112,.268,73,136,.537,.476,36,50,.720,17,100,117,47,17,15,36,69,272
2022,Justin Jackson,SF,26,TOT,4,0,25,5,8,.625,3,5,.600,2,3,.667,.813,2,2,1.000,1,5,6,0,0,0,1,2,15
2022,Reggie Jackson,SG,31,LAC,44,44,1390,279,710,.393,108,332,.325,171,378,.452,.469,78,92,.848,21,129,150,184,34,5,96,84,744
2022,LeBron James,SF,37,LAL,35,35,1285,379,732,.518,98,276,.355,281,456,.616,.585,158,209,.756,39,230,269,221,56,38,111,79,1014
2022,DeJon Jarreau,SG,24,IND,1,0,1,0,0,,0,0,,0,0,,,0,0,,0,0,0,0,0,0,0,0,0
2022,DaQuan Jeffries,SG,24,MEM,3,0,9,1,2,.500,0,1,.000,1,1,1.000,.500,0,0,,0,2,2,1,0,0,0,1,2
2022,Ty Jerome,SG,24,OKC,38,3,591,96,245,.392,38,134,.284,58,111,.523,.469,31,38,.816,15,41,56,65,25,4,27,51,261
2022,Isaiah Joe,SG,22,PHI,31,1,388,39,115,.339,27,87,.310,12,28,.429,.457,18,19,.947,4,33,37,22,9,2,8,29,123
2022,Alize Johnson,PF,25,TOT,19,0,139,14,29,.483,0,4,.000,14,25,.560,.483,4,8,.500,21,27,48,8,3,0,11,15,32
2022,B.J. Johnson,SF,26,ORL,4,0,65,11,25,.440,4,10,.400,7,15,.467,.520,0,0,,6,9,15,0,0,1,0,4,26
2022,Cameron Johnson,PF,25,PHO,43,7,1105,174,382,.455,107,249,.430,67,133,.504,.596,54,64,.844,28,155,183,53,38,10,29,71,509
2022,David Johnson,SG,20,TOR,2,0,2,0,1,.000,0,1,.000,0,0,,.000,0,0,,0,0,0,0,0,0,0,0,0
2022,Jalen Johnson,PF,20,ATL,11,0,52,8,17,.471,2,6,.333,6,11,.545,.529,4,6,.667,0,13,13,1,0,0,2,3,22
2022,James Johnson,PF,34,BRK,31,2,533,62,130,.477,8,31,.258,54,99,.545,.508,6,17,.353,29,76,105,52,13,11,18,64,138
2022,Joe Johnson,SG,40,BOS,1,0,2,1,1,1.000,0,0,,1,1,1.000,1.000,0,0,,0,0,0,0,0,0,0,0,2
2022,Keldon Johnson,SF,22,SAS,43,42,1320,239,517,.462,74,167,.443,165,350,.471,.534,87,123,.707,44,224,268,72,30,6,56,78,639
2022,Keon Johnson,SG,19,LAC,15,0,135,17,51,.333,3,11,.273,14,40,.350,.363,16,21,.762,6,15,21,13,7,2,7,21,53
2022,Stanley Johnson,PF,25,LAL,13,5,268,30,57,.526,11,31,.355,19,26,.731,.623,15,19,.789,6,29,35,17,10,5,7,40,86
2022,Tyler Johnson,PG,29,TOT,6,0,91,6,20,.300,5,13,.385,1,7,.143,.425,0,0,,3,9,12,7,3,3,2,7,17
2022,Nikola Jokić,C,26,DEN,40,40,1327,406,708,.573,61,168,.363,345,540,.639,.617,172,217,.793,112,438,550,302,56,32,141,99,1045
2022,Carlik Jones,PG,24,TOT,5,0,23,1,9,.111,0,1,.000,1,8,.125,.111,2,2,1.000,1,2,3,5,1,0,3,0,4
2022,Damian Jones,C,26,SAC,28,4,405,60,103,.583,3,12,.250,57,91,.626,.597,34,49,.694,44,73,117,27,5,12,28,55,157
2022,Derrick Jones Jr.,PF,24,CHI,31,8,533,71,122,.582,15,37,.405,56,85,.659,.643,39,46,.848,37,67,104,16,15,23,16,71,196
2022,Herbert Jones,C,23,NOP,43,34,1259,152,304,.500,28,73,.384,124,231,.537,.546,61,76,.803,51,108,159,82,63,41,45,133,393
2022,Jemerrio Jones,SF,26,LAL,2,0,15,2,3,.667,0,0,,2,3,.667,.667,0,0,,2,1,3,0,1,0,0,2,4
2022,Kai Jones,C,21,CHO,14,0,39,4,7,.571,0,1,.000,4,6,.667,.571,1,4,.250,1,5,6,2,0,0,5,3,9
2022,Mason Jones,SG,23,LAL,2,0,9,2,8,.250,0,2,.000,2,6,.333,.250,1,2,.500,1,1,2,0,1,0,1,1,5
2022,Tre Jones,PG,22,SAS,37,2,454,65,134,.485,2,14,.143,63,120,.525,.493,22,23,.957,15,57,72,80,14,0,21,34,154
2022,Tyus Jones,PG,25,MEM,45,13,949,145,308,.471,44,114,.386,101,194,.521,.542,35,38,.921,12,110,122,189,39,2,35,19,369
2022,DeAndre Jordan,C,33,LAL,29,18,377,58,86,.674,0,0,,58,86,.674,.674,10,17,.588,45,115,160,13,10,25,19,48,126
2022,Cory Joseph,PG,30,DET,35,9,822,98,212,.462,36,81,.444,62,131,.473,.547,62,74,.838,13,66,79,141,25,6,48,64,294
2022,Georgios Kalaitzakis,SF,23,MIL,9,0,48,5,11,.455,2,4,.500,3,7,.429,.545,4,9,.444,4,4,8,0,1,1,4,8,16
2022,Frank Kaminsky,C,28,PHO,9,0,181,36,66,.545,5,15,.333,31,51,.608,.583,18,20,.900,11,30,41,13,8,7,5,14,95
2022,Luke Kennard,SG,25,LAC,38,10,1091,152,357,.426,104,242,.430,48,115,.417,.571,33,38,.868,7,120,127,77,25,5,32,61,441
2022,Braxton Key,SF,24,PHI,2,0,6,1,2,.500,0,1,.000,1,1,1.000,.500,0,0,,1,1,2,1,1,0,2,1,2
2022,George King,SF,28,DAL,4,0,19,0,5,.000,0,4,.000,0,1,.000,.000,1,2,.500,0,5,5,0,0,0,1,4,1
2022,Louis King,SF,22,SAC,5,0,55,9,26,.346,5,16,.313,4,10,.400,.442,6,7,.857,0,8,8,1,2,0,0,8,29
2022,Corey Kispert,SF,22,WAS,42,7,761,89,205,.434,37,115,.322,52,90,.578,.524,33,38,.868,22,69,91,34,13,11,19,37,248
2022,Maxi Kleber,PF,30,DAL,32,15,791,78,191,.408,52,144,.361,26,47,.553,.545,23,31,.742,35,146,181,38,13,29,26,74,231
2022,Brandon Knight,PG,30,DAL,3,0,54,9,20,.450,4,13,.308,5,7,.714,.550,8,8,1.000,0,7,7,8,1,0,4,5,30
2022,Nathan Knight,PF,24,MIN,23,2,184,24,50,.480,2,7,.286,22,43,.512,.500,28,40,.700,22,35,57,14,4,7,12,26,78
2022,Kevin Knox,SF,22,TOT,16,0,141,19,50,.380,11,35,.314,8,15,.533,.490,7,10,.700,8,18,26,4,3,1,6,7,56
2022,John Konchar,SG,25,MEM,41,5,740,77,149,.517,30,68,.441,47,81,.580,.617,16,27,.593,52,131,183,57,30,12,19,51,200
2022,Furkan Korkmaz,SG,24,PHI,42,15,1013,140,355,.394,59,200,.295,81,155,.523,.477,44,53,.830,13,118,131,100,26,5,35,42,383
2022,Luke Kornet,C,26,TOT,3,0,18,1,6,.167,0,1,.000,1,5,.200,.167,2,3,.667,3,1,4,1,0,1,0,2,4
2022,Vit Krejci,SG,21,OKC,3,0,9,0,2,.000,0,2,.000,0,0,,.000,2,2,1.000,0,3,3,0,0,0,1,0,2
2022,Arnoldas Kulboka,SF,24,CHO,1,0,3,0,0,,0,0,,0,0,,,0,0,,0,0,0,0,0,0,0,0,0
2022,Jonathan Kuminga,SF,19,GSW,35,4,412,78,166,.470,16,54,.296,62,112,.554,.518,49,75,.653,18,64,82,17,13,6,26,52,221
2022,Kyle Kuzma,PF,26,WAS,44,44,1455,259,573,.452,78,238,.328,181,335,.540,.520,91,133,.684,49,338,387,126,27,34,97,88,687
2022,Anthony Lamb,SF,24,SAS,2,0,8,0,2,.000,0,2,.000,0,0,,.000,0,0,,0,1,1,2,0,0,0,0,0
2022,Jeremy Lamb,SF,29,IND,33,0,509,73,197,.371,33,103,.320,40,94,.426,.454,60,68,.882,15,68,83,42,18,12,21,41,239
2022,Jock Landale,C,26,SAS,29,1,298,52,102,.510,16,43,.372,36,59,.610,.588,20,23,.870,36,31,67,29,5,11,20,25,140
2022,Romeo Langford,SG,22,BOS,37,5,659,71,163,.436,25,73,.342,46,90,.511,.512,18,28,.643,29,70,99,18,21,15,15,42,185
2022,Zach LaVine,SF,26,CHI,39,39,1327,349,717,.487,115,282,.408,234,435,.538,.567,158,182,.868,12,176,188,165,25,14,111,61,971
2022,Jake Layman,SF,27,MIN,20,1,159,17,46,.370,4,24,.167,13,22,.591,.413,6,8,.750,4,19,23,5,6,3,7,8,44
2022,Damion Lee,SG,29,GSW,36,2,734,108,236,.458,42,114,.368,66,122,.541,.547,37,43,.860,14,96,110,32,21,4,25,57,295
2022,Saben Lee,PG,22,DET,26,0,400,46,121,.380,12,44,.273,34,77,.442,.430,33,43,.767,10,56,66,62,25,10,25,24,137
2022,Alex Len,C,28,SAC,30,9,523,79,151,.523,6,19,.316,73,132,.553,.543,34,52,.654,48,97,145,36,10,25,38,87,198
2022,Caris LeVert,SG,27,IND,33,33,1012,233,524,.445,55,166,.331,178,358,.497,.497,88,112,.786,25,96,121,139,32,16,62,74,609
2022,Kira Lewis Jr.,PG,20,NOP,24,0,341,59,146,.404,13,58,.224,46,88,.523,.449,10,12,.833,9,30,39,49,11,1,26,17,141
2022,Scottie Lewis,SG,21,CHO,2,0,7,0,0,,0,0,,0,0,,,1,2,.500,0,0,0,1,1,0,0,0,1
2022,Damian Lillard,PG,31,POR,29,29,1056,222,552,.402,92,284,.324,130,268,.485,.486,159,181,.878,13,107,120,212,17,11,83,37,695
2022,Nassir Little,SF,21,POR,41,22,1059,138,304,.454,47,148,.318,91,156,.583,.531,67,91,.736,55,173,228,52,25,36,39,81,390
2022,Isaiah Livers,SF,23,DET,1,0,5,0,2,.000,0,2,.000,0,0,,.000,0,0,,0,0,0,0,1,1,1,1,0
2022,Kevon Looney,C,25,GSW,47,47,973,121,219,.553,0,1,.000,121,218,.555,.553,49,76,.645,126,214,340,77,27,37,41,124,291
2022,Brook Lopez,C,33,MIL,1,1,28,3,9,.333,2,4,.500,1,5,.200,.444,0,0,,2,3,5,0,1,3,0,3,8
2022,Robin Lopez,C,33,ORL,22,9,409,84,144,.583,1,4,.250,83,140,.593,.587,19,32,.594,50,34,84,42,1,12,29,45,188
2022,Didi Louzada,SF,22,NOP,2,0,7,0,3,.000,0,3,.000,0,0,,.000,0,0,,2,0,2,1,0,0,0,0,0
2022,Kevin Love,PF,33,CLE,40,2,857,172,396,.434,99,246,.402,73,150,.487,.559,115,132,.871,42,246,288,86,12,8,50,38,558
2022,Kyle Lowry,PG,35,MIA,39,39,1333,174,422,.412,81,248,.327,93,174,.534,.508,94,111,.847,24,150,174,323,40,15,119,109,523
2022,Timothé Luwawu-Cabarrot,SF,26,ATL,31,12,430,46,118,.390,29,82,.354,17,36,.472,.513,17,20,.850,8,38,46,25,11,3,13,46,138
2022,Trey Lyles,PF,26,DET,43,3,834,142,318,.447,36,126,.286,106,192,.552,.503,110,142,.775,54,153,207,51,16,20,42,75,430
2022,Théo Maledon,PG,20,OKC,21,0,285,22,78,.282,8,44,.182,14,34,.412,.333,26,30,.867,8,29,37,22,10,2,18,22,78
2022,Sandro Mamukelashvili,PF,22,MIL,24,2,273,32,75,.427,13,35,.371,19,40,.475,.513,9,12,.750,26,26,52,13,7,6,9,17,86
2022,Terance Mann,SF,25,LAC,47,15,1375,184,385,.478,49,132,.371,135,253,.534,.542,64,86,.744,66,182,248,107,26,6,50,105,481
2022,Tre Mann,PG,20,OKC,34,2,583,91,229,.397,35,97,.361,56,132,.424,.474,20,30,.667,12,62,74,26,18,7,22,56,237
2022,Boban Marjanović,C,33,DAL,16,0,95,35,56,.625,1,3,.333,34,53,.642,.634,8,16,.500,7,23,30,2,0,2,11,19,79
2022,Lauri Markkanen,PF,24,CLE,38,38,1148,188,431,.436,77,225,.342,111,206,.539,.526,63,73,.863,41,161,202,56,29,21,31,68,516
2022,Naji Marshall,SF,24,NOP,23,0,220,23,70,.329,4,28,.143,19,42,.452,.357,25,29,.862,14,42,56,20,9,3,20,22,75
2022,Caleb Martin,SF,26,MIA,37,9,856,139,268,.519,39,102,.382,100,166,.602,.591,43,60,.717,46,100,146,34,39,20,30,65,360
2022,Cody Martin,SF,26,CHO,42,7,1135,125,267,.468,43,95,.453,82,172,.477,.549,50,70,.714,52,124,176,113,59,21,36,68,343
2022,Kelan Martin,SF,26,IND,27,1,444,70,168,.417,22,74,.297,48,94,.511,.482,9,13,.692,16,37,53,21,13,9,14,36,171
2022,Kenyon Martin Jr.,SF,21,HOU,44,0,840,141,274,.515,25,81,.309,116,193,.601,.560,46,70,.657,45,121,166,61,19,24,29,57,353
2022,Garrison Mathews,SG,25,HOU,30,16,828,99,238,.416,75,199,.377,24,39,.615,.574,72,88,.818,15,92,107,26,20,11,19,91,345
2022,Dakota Mathias,SG,26,MEM,6,0,16,2,6,.333,2,6,.333,0,0,,.500,0,0,,0,2,2,1,1,0,0,1,6
2022,Wesley Matthews,SG,35,MIL,21,6,432,49,107,.458,30,76,.395,19,31,.613,.598,4,8,.500,13,32,45,16,11,5,9,37,132
2022,Tyrese Maxey,PG,21,PHI,39,38,1377,244,523,.467,55,135,.407,189,388,.487,.519,109,124,.879,15,119,134,174,26,20,46,81,652
2022,Skylar Mays,SG,24,ATL,18,5,185,31,60,.517,8,25,.320,23,35,.657,.583,7,7,1.000,5,19,24,14,7,0,6,6,77
2022,Miles McBride,PG,21,NYK,18,2,146,15,54,.278,5,28,.179,10,26,.385,.324,3,4,.750,2,14,16,21,8,1,3,15,38
2022,Mac McClung,PG,23,CHI,1,0,3,1,1,1.000,0,0,,1,1,1.000,1.000,0,0,,0,0,0,0,0,0,1,0,2
2022,CJ McCollum,SG,30,POR,28,28,983,223,515,.433,91,224,.406,132,291,.454,.521,40,57,.702,28,90,118,123,31,20,61,60,577
2022,T.J. McConnell,PG,29,IND,24,6,581,91,181,.503,7,25,.280,84,156,.538,.522,12,15,.800,19,61,80,115,25,9,28,43,201
2022,Jaden McDaniels,PF,21,MIN,43,18,1110,141,336,.420,40,149,.268,101,187,.540,.479,29,37,.784,57,132,189,43,35,29,47,144,351
2022,Jalen McDaniels,SF,24,CHO,39,2,685,97,197,.492,32,86,.372,65,111,.586,.574,31,46,.674,29,107,136,43,20,16,30,70,257
2022,Doug McDermott,PF,30,SAS,32,32,789,137,301,.455,68,166,.410,69,135,.511,.568,19,27,.704,13,65,78,38,7,3,26,48,361
2022,JaVale McGee,C,34,PHO,42,14,683,179,275,.651,1,4,.250,178,271,.657,.653,62,92,.674,99,198,297,26,13,37,62,113,421
2022,Cameron McGriff,SF,24,POR,3,0,46,5,14,.357,2,6,.333,3,8,.375,.429,2,2,1.000,6,9,15,3,0,1,0,7,14
2022,Rodney McGruder,SG,30,DET,21,0,263,37,78,.474,19,45,.422,18,33,.545,.596,4,6,.667,13,30,43,15,6,2,12,19,97
2022,Alfonzo McKinnie,SF,29,CHI,14,3,200,24,59,.407,9,26,.346,15,33,.455,.483,1,6,.167,13,17,30,5,2,3,7,25,58
2022,JaQuori McLaughlin,PG,24,DAL,4,0,11,0,2,.000,0,1,.000,0,1,.000,.000,0,0,,0,0,0,2,0,0,0,1,0
2022,Jordan McLaughlin,PG,25,MIN,29,2,316,21,74,.284,4,28,.143,17,46,.370,.311,15,22,.682,6,24,30,66,18,1,19,13,61
2022,Ben McLemore,SG,28,POR,29,4,500,88,206,.427,68,165,.412,20,41,.488,.592,19,24,.792,7,32,39,23,11,4,21,44,263
2022,De'Anthony Melton,SG,23,MEM,40,13,916,141,368,.383,60,189,.317,81,179,.453,.465,47,67,.701,39,136,175,110,64,23,60,75,389
2022,Sam Merrill,SG,25,MEM,6,0,58,8,24,.333,7,23,.304,1,1,1.000,.479,2,4,.500,1,6,7,4,0,0,2,3,25
2022,Chimezie Metu,C,24,SAC,32,19,710,110,262,.420,32,117,.274,78,145,.538,.481,32,43,.744,21,172,193,35,28,20,29,47,284
2022,Khris Middleton,SF,30,MIL,37,37,1182,248,561,.442,90,230,.391,158,331,.477,.522,156,176,.886,23,187,210,197,42,12,117,87,742
2022,C.J. Miles,SG,34,BOS,1,0,2,0,0,,0,0,,0,0,,,0,0,,0,0,0,0,0,0,0,1,0
2022,Patty Mills,PG,33,BRK,45,28,1395,216,490,.441,145,341,.425,71,149,.477,.589,31,35,.886,10,87,97,113,28,13,45,63,608
2022,Paul Millsap,PF,36,BRK,24,0,270,32,85,.376,6,27,.222,26,58,.448,.412,12,17,.706,29,60,89,24,5,11,11,48,82
2022,Shake Milton,PG,25,PHI,27,6,668,109,254,.429,25,79,.316,84,175,.480,.478,41,48,.854,13,68,81,75,20,11,31,56,284
2022,Davion Mitchell,PG,23,SAC,42,1,1031,157,397,.395,48,156,.308,109,241,.452,.456,22,37,.595,23,73,96,135,29,13,42,76,384
2022,Donovan Mitchell,SG,25,UTA,40,40,1340,372,826,.450,128,378,.339,244,448,.545,.528,148,169,.876,33,125,158,206,64,9,118,101,1020
2022,Evan Mobley,PF,20,CLE,40,40,1376,247,484,.510,17,56,.304,230,428,.537,.528,89,132,.674,73,254,327,106,30,66,78,80,600
2022,Malik Monk,SG,23,LAL,42,11,1097,185,388,.477,87,215,.405,98,173,.566,.589,42,51,.824,20,107,127,96,31,19,55,65,499
2022,Greg Monroe,C,31,TOT,5,0,81,13,22,.591,0,0,,13,22,.591,.591,2,5,.400,12,19,31,12,3,5,6,9,28
2022,Moses Moody,SG,19,GSW,26,1,183,20,59,.339,4,33,.121,16,26,.615,.373,12,15,.800,4,23,27,8,3,4,4,12,56
2022,Xavier Moon,SG,27,LAC,6,0,83,14,34,.412,3,10,.300,11,24,.458,.456,2,3,.667,1,8,9,10,5,1,3,4,33
2022,Matt Mooney,SG,24,NYK,1,0,2,0,1,.000,0,1,.000,0,0,,.000,0,0,,0,0,0,0,1,0,1,0,0
2022,Ja Morant,PG,22,MEM,36,36,1184,340,698,.487,55,157,.350,285,541,.527,.527,177,229,.773,53,162,215,247,46,14,122,51,912
2022,Juwan Morgan,PF,24,TOR,1,0,27,2,3,.667,1,2,.500,1,1,1.000,.833,0,0,,2,2,4,1,0,0,0,3,5
2022,Jaylen Morris,SG,26,SAS,3,0,16,0,6,.000,0,2,.000,0,4,.000,.000,2,4,.500,0,2,2,2,0,0,1,2,2
2022,Marcus Morris,PF,32,LAC,26,26,789,143,343,.417,51,140,.364,92,203,.453,.491,67,78,.859,15,119,134,56,13,9,35,61,404
2022,Markieff Morris,PF,32,MIA,10,0,187,32,70,.457,8,22,.364,24,48,.500,.514,5,5,1.000,13,15,28,14,3,1,12,22,77
2022,Monte Morris,PG,26,DEN,42,41,1260,215,457,.470,69,185,.373,146,272,.537,.546,29,37,.784,13,104,117,173,31,5,49,55,528
2022,Emmanuel Mudiay,PG,25,SAC,2,0,11,0,2,.000,0,0,,0,2,.000,.000,3,4,.750,0,0,0,4,1,0,1,1,3
2022,Mychal Mulder,PG,27,ORL,15,2,195,20,67,.299,13,46,.283,7,21,.333,.396,2,2,1.000,2,19,21,3,4,1,8,12,55
2022,Ade Murkey,SG,24,SAC,1,0,1,0,0,,0,0,,0,0,,,0,0,,0,0,0,0,0,0,0,0,0
2022,Trey Murphy III,SF,21,NOP,36,0,459,44,134,.328,33,97,.340,11,37,.297,.451,14,17,.824,25,51,76,20,11,5,11,34,135
2022,Dejounte Murray,PG,25,SAS,42,42,1446,336,748,.449,57,177,.322,279,571,.489,.487,81,111,.730,56,300,356,378,83,16,101,84,810
2022,Mike Muscala,C,30,OKC,39,0,527,104,225,.462,65,150,.433,39,75,.520,.607,44,50,.880,16,96,112,20,16,23,13,52,317
2022,Svi Mykhailiuk,SF,24,TOR,38,5,642,82,201,.408,35,111,.315,47,90,.522,.495,27,32,.844,19,67,86,40,24,4,27,47,226
2022,Abdel Nader,SF,28,PHO,14,0,145,12,35,.343,4,14,.286,8,21,.381,.400,6,10,.600,4,23,27,7,8,4,11,20,34
2022,Larry Nance Jr.,PF,29,POR,37,11,858,102,198,.515,19,62,.306,83,136,.610,.563,32,49,.653,58,151,209,73,38,13,27,67,255
2022,RJ Nembhard Jr.,SG,22,CLE,6,0,42,5,11,.455,0,1,.000,5,10,.500,.455,1,2,.500,0,2,2,10,0,0,1,2,11
2022,Aaron Nesmith,SF,22,BOS,32,1,335,38,104,.365,16,68,.235,22,36,.611,.442,10,13,.769,8,48,56,11,10,2,19,41,102
2022,Raul Neto,PG,29,WAS,40,0,790,117,262,.447,15,67,.224,102,195,.523,.475,44,58,.759,7,74,81,102,27,1,50,61,293
2022,Malik Newman,PG,24,CLE,1,0,8,3,5,.600,0,1,.000,3,4,.750,.600,2,2,1.000,0,1,1,1,0,0,1,0,8
2022,Georges Niang,PF,28,PHI,42,5,969,142,331,.429,81,210,.386,61,121,.504,.551,36,41,.878,16,99,115,57,21,8,29,109,401
2022,Daishen Nix,SG,19,HOU,8,0,67,13,20,.650,3,7,.429,10,13,.769,.725,1,3,.333,1,9,10,10,7,0,9,3,30
2022,Zeke Nnaji,PF,21,DEN,29,0,434,63,126,.500,27,55,.491,36,71,.507,.607,29,46,.630,34,63,97,8,7,8,9,53,182
2022,Nerlens Noel,C,27,NYK,20,11,469,29,53,.547,0,3,.000,29,50,.580,.547,15,21,.714,45,80,125,15,24,28,16,53,73
2022,Jaylen Nowell,SG,22,MIN,31,0,451,100,205,.488,27,71,.380,73,134,.545,.554,32,44,.727,10,55,65,64,17,6,16,34,259
2022,Frank Ntilikina,PG,23,DAL,36,5,459,55,147,.374,27,76,.355,28,71,.394,.466,19,19,1.000,7,44,51,47,22,3,23,39,156
2022,Jusuf Nurkić,C,27,POR,43,43,1168,234,433,.540,9,44,.205,225,389,.578,.551,136,196,.694,116,349,465,118,52,26,106,147,613
2022,David Nwaba,SF,29,HOU,33,4,469,67,141,.475,10,35,.286,57,106,.538,.511,33,47,.702,29,100,129,27,22,18,15,41,177
2022,Jordan Nwora,SF,23,MIL,37,9,751,123,298,.413,57,152,.375,66,146,.452,.508,14,19,.737,25,125,150,38,19,13,38,45,317
2022,Royce O'Neale,SF,28,UTA,44,44,1392,113,236,.479,63,158,.399,50,78,.641,.612,29,38,.763,38,191,229,108,56,23,38,110,318
2022,Semi Ojeleye,PF,27,MIL,17,0,291,15,67,.224,9,39,.231,6,28,.214,.291,9,11,.818,25,32,57,5,5,5,5,26,48
2022,Chuma Okeke,PF,23,ORL,37,10,877,104,284,.366,48,167,.287,56,117,.479,.451,28,33,.848,24,146,170,51,50,17,31,50,284
2022,Josh Okogie,SG,23,MIN,30,6,385,25,72,.347,9,33,.273,16,39,.410,.410,23,37,.622,25,35,60,18,17,9,15,39,82
2022,Onyeka Okongwu,C,21,ATL,14,6,337,52,70,.743,0,0,,52,70,.743,.743,25,36,.694,34,53,87,16,9,25,18,48,129
2022,Isaac Okoro,SF,21,CLE,33,27,937,109,240,.454,26,92,.283,83,148,.561,.508,58,79,.734,37,74,111,58,27,10,38,83,302
2022,KZ Okpala,PF,22,MIA,21,0,244,30,69,.435,9,26,.346,21,43,.488,.500,8,11,.727,11,30,41,14,4,7,5,25,77
2022,Cameron Oliver,SF,25,ATL,2,0,43,10,15,.667,1,3,.333,9,12,.750,.700,2,3,.667,2,4,6,3,1,1,0,5,23
2022,Kelly Olynyk,C,30,DET,12,1,271,54,121,.446,16,51,.314,38,70,.543,.512,27,43,.628,17,49,66,33,15,8,18,33,151
2022,Eugene Omoruyi,SF,24,DAL,4,0,18,2,5,.400,1,2,.500,1,3,.333,.500,2,4,.500,2,5,7,2,0,0,0,2,7
2022,Miye Oni,SG,24,UTA,16,0,44,2,9,.222,1,8,.125,1,1,1.000,.278,0,1,.000,1,6,7,5,0,0,1,7,5
2022,Cedi Osman,SF,26,CLE,36,0,802,132,311,.424,70,198,.354,62,113,.549,.537,41,63,.651,15,73,88,60,34,8,30,65,375
2022,Daniel Oturu,C,22,TOR,3,0,27,3,6,.500,0,1,.000,3,5,.600,.500,3,5,.600,1,4,5,0,0,2,0,1,9
2022,Kelly Oubre Jr.,SF,26,CHO,43,10,1196,258,571,.452,120,333,.360,138,238,.580,.557,66,101,.653,44,126,170,49,49,15,44,104,702
2022,Jaysean Paige,PG,27,DET,1,0,7,0,3,.000,0,2,.000,0,1,.000,.000,0,0,,0,1,1,1,0,0,1,2,0
2022,Trayvon Palmer,SG,27,DET,1,0,17,0,1,.000,0,0,,0,1,.000,.000,0,0,,0,2,2,0,0,0,1,2,0
2022,Kevin Pangos,PG,29,CLE,20,3,161,15,45,.333,6,26,.231,9,19,.474,.400,3,4,.750,2,9,11,30,3,0,7,10,39
2022,Jabari Parker,PF,26,BOS,12,0,112,18,38,.474,8,16,.500,10,22,.455,.579,9,9,1.000,5,23,28,6,4,1,8,13,53
2022,Eric Paschall,PF,25,UTA,34,1,416,60,122,.492,21,59,.356,39,63,.619,.578,34,46,.739,22,45,67,18,4,4,19,33,175
2022,Chris Paul,PG,36,PHO,46,46,1500,252,517,.487,46,140,.329,206,377,.546,.532,112,133,.842,15,187,202,470,90,15,109,98,662
2022,Cameron Payne,PG,27,PHO,40,0,815,158,391,.404,45,134,.336,113,257,.440,.462,57,66,.864,16,94,110,144,23,12,71,75,418
2022,Elfrid Payton,PG,27,PHO,26,0,284,39,96,.406,1,7,.143,38,89,.427,.411,8,16,.500,13,37,50,45,13,2,24,24,87
2022,Gary Payton II,PG,29,GSW,44,9,738,142,225,.631,29,77,.377,113,148,.764,.696,24,42,.571,49,115,164,36,59,11,23,76,337
2022,Norvel Pelle,C,28,UTA,3,0,19,3,5,.600,0,0,,3,5,.600,.600,0,0,,3,3,6,0,0,1,2,1,6
2022,Reggie Perry,PF,21,POR,2,0,41,4,9,.444,1,2,.500,3,7,.429,.500,2,2,1.000,2,5,7,2,1,0,1,6,11
2022,Jamorko Pickett,PF,24,DET,6,0,47,1,10,.100,1,7,.143,0,3,.000,.150,0,0,,2,7,9,1,0,1,3,3,3
2022,Theo Pinson,SF,26,DAL,12,0,96,8,27,.296,5,20,.250,3,7,.429,.389,4,4,1.000,0,16,16,12,4,2,2,9,25
2022,Mason Plumlee,C,31,CHO,38,38,934,111,176,.631,0,1,.000,111,175,.634,.631,28,80,.350,86,185,271,102,31,29,45,113,250
2022,Jakob Poeltl,C,26,SAS,39,38,1136,226,378,.598,0,0,,226,378,.598,.598,46,105,.438,158,196,354,106,27,64,62,118,498
2022,Aleksej Pokusevski,PF,20,OKC,36,2,544,69,193,.358,20,87,.230,49,106,.462,.409,7,14,.500,33,112,145,40,18,17,42,44,165
2022,Yves Pons,SF,22,MEM,6,0,21,1,3,.333,1,1,1.000,0,2,.000,.500,0,2,.000,2,3,5,0,0,0,0,2,3
2022,Jordan Poole,SG,22,GSW,41,33,1204,235,539,.436,101,298,.339,134,241,.556,.530,115,127,.906,11,111,122,135,32,12,97,113,686
2022,Kevin Porter Jr.,PG,21,HOU,31,31,935,140,369,.379,61,179,.341,79,190,.416,.462,66,104,.635,23,107,130,184,41,9,112,80,407
2022,Michael Porter Jr.,SF,23,DEN,9,9,265,37,103,.359,10,48,.208,27,55,.491,.408,5,9,.556,9,50,59,17,10,2,12,16,89
2022,Otto Porter Jr.,PF,28,GSW,40,8,868,126,267,.472,62,154,.403,64,113,.566,.588,20,28,.714,38,174,212,66,45,18,22,51,334
2022,Bobby Portis,C,26,MIL,40,35,1148,232,490,.473,75,181,.414,157,309,.508,.550,60,78,.769,116,263,379,51,29,35,63,110,599
2022,Kristaps Porziņģis,PF,26,DAL,31,31,938,215,470,.457,47,162,.290,168,308,.545,.507,141,162,.870,63,185,248,67,23,57,47,79,618
2022,Micah Potter,C,23,DET,3,0,31,5,11,.455,0,2,.000,5,9,.556,.455,2,2,1.000,4,5,9,0,1,1,1,4,12
2022,Dwight Powell,C,30,DAL,47,39,948,124,197,.629,12,29,.414,112,168,.667,.660,72,99,.727,92,118,210,52,20,16,33,111,332
2022,Myles Powell,PG,24,PHI,9,0,46,5,16,.313,1,5,.200,4,11,.364,.344,2,2,1.000,1,4,5,3,1,0,3,6,13
2022,Norman Powell,SF,28,POR,34,34,1120,211,464,.455,75,188,.399,136,276,.493,.536,137,167,.820,14,84,98,73,34,15,52,77,634
2022,Joshua Primo,SG,19,SAS,20,4,269,29,77,.377,14,41,.341,15,36,.417,.468,10,12,.833,8,23,31,26,8,10,18,18,82
2022,Taurean Prince,PF,27,MIN,35,8,510,59,143,.413,30,90,.333,29,53,.547,.517,20,26,.769,13,57,70,29,15,7,21,47,168
2022,Payton Pritchard,SG,24,BOS,38,2,506,67,183,.366,43,117,.368,24,66,.364,.484,8,8,1.000,12,55,67,66,7,4,26,34,185
2022,Trevelin Queen,SG,24,HOU,8,0,69,13,29,.448,8,22,.364,5,7,.714,.586,3,3,1.000,5,9,14,3,5,0,7,6,37
2022,Neemias Queta,C,22,SAC,6,0,40,5,15,.333,0,0,,5,15,.333,.333,3,4,.750,6,7,13,3,1,1,2,7,13
2022,Immanuel Quickley,PG,22,NYK,44,2,986,147,389,.378,77,224,.344,70,165,.424,.477,73,80,.913,16,90,106,128,30,3,55,96,444
2022,Jahmi'us Ramsey,SG,20,SAC,15,0,83,14,34,.412,2,11,.182,12,23,.522,.441,5,10,.500,1,4,5,3,1,1,2,5,35
2022,Julius Randle,PF,27,NYK,46,46,1631,312,757,.412,79,254,.311,233,503,.463,.464,165,218,.757,80,377,457,233,36,29,159,129,868
2022,Austin Reaves,SG,23,LAL,28,0,579,56,116,.483,22,65,.338,34,51,.667,.578,32,37,.865,12,57,69,29,8,3,17,43,166
2022,Cam Reddish,SF,22,TOT,35,7,802,139,345,.403,58,154,.377,81,191,.424,.487,72,80,.900,20,66,86,38,35,11,44,45,408
2022,Davon Reed,SG,26,DEN,19,2,310,33,70,.471,15,34,.441,18,36,.500,.579,4,5,.800,9,45,54,22,16,3,4,34,85
2022,Paul Reed,C,22,PHI,21,2,185,20,43,.465,0,4,.000,20,39,.513,.465,3,8,.375,20,27,47,10,12,10,7,28,43
2022,Naz Reid,C,22,MIN,43,5,706,135,298,.453,35,105,.333,100,193,.518,.512,67,92,.728,66,111,177,33,20,45,44,96,372
2022,Nick Richards,C,24,CHO,34,5,296,50,73,.685,0,0,,50,73,.685,.685,24,31,.774,27,44,71,11,9,19,18,44,124
2022,Josh Richardson,SG,28,BOS,36,0,905,124,283,.438,49,123,.398,75,160,.469,.525,51,60,.850,22,75,97,55,30,17,29,69,348
2022,Austin Rivers,SG,29,DEN,32,10,662,68,176,.386,36,116,.310,32,60,.533,.489,13,21,.619,11,44,55,34,17,2,24,51,185
2022,Duncan Robinson,SG,27,MIA,44,39,1222,177,450,.393,135,377,.358,42,73,.575,.543,32,40,.800,18,123,141,66,31,9,37,117,521
2022,Justin Robinson,PG,24,TOT,25,0,304,28,93,.301,18,61,.295,10,32,.313,.398,4,8,.500,4,17,21,32,9,1,17,27,78
2022,Mitchell Robinson,C,23,NYK,43,34,1071,152,195,.779,0,0,,152,195,.779,.779,57,104,.548,151,205,356,19,22,64,32,113,361
2022,Jeremiah Robinson-Earl,C,21,OKC,43,35,992,114,283,.403,50,147,.340,64,136,.471,.491,29,41,.707,69,179,248,44,26,14,35,71,307
2022,Isaiah Roby,PF,23,OKC,18,5,246,47,84,.560,11,22,.500,36,62,.581,.625,16,21,.762,20,39,59,13,4,6,15,26,121
2022,Rajon Rondo,PG,35,TOT,22,0,372,36,99,.364,16,47,.340,20,52,.385,.444,6,8,.750,11,54,65,84,16,5,43,33,94
2022,Derrick Rose,PG,33,NYK,26,4,636,122,274,.445,37,92,.402,85,182,.467,.513,30,31,.968,21,57,78,103,22,12,39,15,311
2022,Terrence Ross,SG,30,ORL,39,0,992,156,384,.406,54,174,.310,102,210,.486,.477,91,105,.867,14,92,106,81,21,9,55,51,457
2022,Terry Rozier,SG,27,CHO,38,38,1240,257,595,.432,113,303,.373,144,292,.493,.527,75,93,.806,26,131,157,153,45,15,43,53,702
2022,Ricky Rubio,PG,31,CLE,34,8,970,149,411,.363,59,174,.339,90,237,.380,.434,88,103,.854,15,126,141,225,49,7,90,75,445
2022,D'Angelo Russell,PG,25,MIN,36,36,1169,237,577,.411,109,308,.354,128,269,.476,.505,102,125,.816,12,119,131,254,35,19,96,80,685
2022,Domantas Sabonis,C,25,IND,44,43,1534,310,537,.577,34,104,.327,276,433,.637,.609,180,242,.744,141,382,523,214,44,19,131,135,834
2022,Olivier Sarr,C,22,OKC,2,0,14,1,3,.333,0,1,.000,1,2,.500,.333,2,2,1.000,0,5,5,0,0,2,0,1,4
2022,Tomáš Satoranský,SG,30,NOP,31,3,462,32,103,.311,5,30,.167,27,73,.370,.335,19,25,.760,18,45,63,71,14,1,23,32,88
2022,Jordan Schakel,SG,23,WAS,2,0,14,0,6,.000,0,3,.000,0,3,.000,.000,0,0,,2,1,3,0,0,0,0,0,0
2022,Admiral Schofield,SF,24,ORL,16,1,211,24,47,.511,9,26,.346,15,21,.714,.606,2,3,.667,6,36,42,13,2,3,11,26,59
2022,Dennis Schröder,SG,28,BOS,41,25,1290,233,526,.443,61,170,.359,172,356,.483,.501,116,136,.853,25,116,141,191,38,3,91,99,643
2022,Tre Scott,SF,25,CLE,2,0,11,3,6,.500,0,1,.000,3,5,.600,.500,0,0,,1,1,2,0,1,1,0,2,6
2022,Jay Scrubb,SG,21,LAC,14,0,95,15,40,.375,5,19,.263,10,21,.476,.438,4,7,.571,2,9,11,7,3,3,5,5,39
2022,Wayne Selden,SG,27,NYK,3,0,19,1,4,.250,1,2,.500,0,2,.000,.375,2,4,.500,0,1,1,1,0,0,0,1,5
2022,Alperen Şengün,C,19,HOU,39,2,703,120,243,.494,13,45,.289,107,198,.540,.521,89,127,.701,65,114,179,100,32,33,77,112,342
2022,Collin Sexton,SG,23,CLE,11,11,316,68,151,.450,11,45,.244,57,106,.538,.487,29,39,.744,13,23,36,23,10,0,31,25,176
2022,Landry Shamet,SG,24,PHO,42,7,842,101,272,.371,66,188,.351,35,84,.417,.493,43,51,.843,10,71,81,65,20,4,23,49,311
2022,Day'Ron Sharpe,PF,20,BRK,21,7,258,61,103,.592,1,3,.333,60,100,.600,.597,15,23,.652,51,52,103,7,6,12,22,46,138
2022,Pascal Siakam,PF,27,TOR,31,31,1134,253,527,.480,33,100,.330,220,427,.515,.511,118,164,.720,62,194,256,151,37,22,80,108,657
2022,Chris Silva,PF,25,TOT,8,0,66,8,13,.615,0,0,,8,13,.615,.615,8,10,.800,10,17,27,3,0,0,4,13,24
2022,Marko Simonovic,C,22,CHI,9,0,35,4,15,.267,1,5,.200,3,10,.300,.300,8,11,.727,5,5,10,0,1,1,2,6,17
2022,Anfernee Simons,SG,22,POR,40,13,1100,218,492,.443,107,267,.401,111,225,.493,.552,63,69,.913,19,84,103,137,20,6,64,77,606
2022,Jericho Sims,PF,23,NYK,14,0,89,6,8,.750,0,0,,6,8,.750,.750,3,4,.750,8,14,22,1,2,5,2,6,15
2022,Deividas Sirvydis,SG,21,DET,3,0,27,1,10,.100,1,7,.143,0,3,.000,.150,0,0,,0,6,6,1,3,1,0,4,3
2022,Javonte Smart,PG,22,MIL,13,1,160,11,43,.256,4,18,.222,7,25,.280,.302,5,6,.833,4,15,19,14,4,2,9,11,31
2022,Marcus Smart,PG,27,BOS,39,39,1325,157,398,.394,57,187,.305,100,211,.474,.466,80,101,.792,24,131,155,207,78,11,81,98,451
2022,Dennis Smith Jr.,PG,24,POR,28,4,484,64,154,.416,6,27,.222,58,127,.457,.435,32,47,.681,13,49,62,94,33,10,40,40,166
2022,Ish Smith,PG,33,CHO,30,1,423,58,152,.382,8,20,.400,50,132,.379,.408,12,19,.632,7,40,47,80,19,7,32,29,136
2022,Jalen Smith,PF,21,PHO,22,4,305,52,113,.460,7,30,.233,45,83,.542,.491,34,41,.829,48,72,120,5,5,14,17,38,145
2022,Xavier Sneed,SF,24,MEM,2,0,8,0,2,.000,0,2,.000,0,0,,.000,0,0,,1,1,2,0,0,0,0,2,0
2022,Tony Snell,SG,30,POR,32,7,421,26,73,.356,18,56,.321,8,17,.471,.479,3,3,1.000,10,45,55,17,5,4,10,35,73
2022,Jaden Springer,SG,19,PHI,2,0,6,1,1,1.000,0,0,,1,1,1.000,1.000,0,0,,1,1,2,0,0,2,1,0,2
2022,Cassius Stanley,SG,22,DET,8,1,152,18,45,.400,4,17,.235,14,28,.500,.444,10,10,1.000,5,14,19,4,5,2,6,17,50
2022,Nik Stauskas,SG,28,MIA,2,0,24,3,8,.375,2,4,.500,1,4,.250,.500,3,4,.750,1,2,3,1,0,0,0,1,11
2022,Lance Stephenson,SG-SF,31,TOT,18,0,297,49,110,.445,11,39,.282,38,71,.535,.495,14,19,.737,5,42,47,56,8,1,27,35,123
2022,Lamar Stevens,PF,24,CLE,32,8,485,71,149,.477,13,40,.325,58,109,.532,.520,16,25,.640,24,51,75,21,12,7,18,47,171
2022,Isaiah Stewart,C,20,DET,38,38,957,131,245,.535,3,21,.143,128,224,.571,.541,39,58,.672,98,202,300,43,13,46,50,110,304
2022,Max Strus,SF,25,MIA,36,8,862,145,320,.453,96,235,.409,49,85,.576,.603,31,40,.775,15,108,123,46,11,7,26,58,417
2022,Jalen Suggs,PG,20,ORL,27,24,751,119,326,.365,29,117,.248,90,209,.431,.410,80,105,.762,19,85,104,108,32,12,89,77,347
2022,Craig Sword,SG,28,WAS,3,0,19,3,4,.750,0,1,.000,3,3,1.000,.750,0,0,,0,0,0,1,4,0,1,7,6
2022,Keifer Sykes,PG,28,IND,12,8,270,35,88,.398,13,41,.317,22,47,.468,.472,8,9,.889,5,21,26,31,6,1,19,25,91
2022,Jae'Sean Tate,SF,26,HOU,45,44,1224,223,443,.503,36,119,.303,187,324,.577,.544,82,117,.701,77,180,257,141,39,28,83,162,564
2022,Jayson Tatum,SF,23,BOS,44,44,1616,392,928,.422,118,364,.324,274,564,.486,.486,234,277,.845,52,326,378,171,41,33,131,109,1136
2022,Terry Taylor,SG,22,IND,2,0,6,0,0,,0,0,,0,0,,,0,0,,0,1,1,1,0,0,0,0,0
2022,Garrett Temple,SG,35,NOP,44,13,862,93,236,.394,51,148,.345,42,88,.477,.502,24,32,.750,26,93,119,53,33,17,35,69,261
2022,Emanuel Terry,PF,25,PHO,3,0,18,0,5,.000,0,0,,0,5,.000,.000,0,0,,8,7,15,2,1,0,5,4,0
2022,Tyrell Terry,PG,21,MEM,2,0,3,1,1,1.000,0,0,,1,1,1.000,1.000,0,0,,0,0,0,0,0,0,0,1,2
2022,Jon Teske,C,24,MEM,3,0,8,0,1,.000,0,0,,0,1,.000,.000,0,2,.000,0,2,2,1,1,0,0,1,0
2022,Daniel Theis,C,29,HOU,26,21,584,84,179,.469,23,79,.291,61,100,.610,.534,27,40,.675,32,98,130,20,11,17,31,62,218
2022,Brodric Thomas,SG,25,BOS,7,0,28,1,9,.111,0,6,.000,1,3,.333,.111,2,2,1.000,2,3,5,5,0,0,3,1,4
2022,Cam Thomas,SG,20,BRK,35,1,607,106,243,.436,22,92,.239,84,151,.556,.481,28,35,.800,6,78,84,35,18,4,26,27,262
2022,Isaiah Thomas,PG,32,TOT,5,1,114,15,47,.319,5,25,.200,10,22,.455,.372,8,11,.727,1,7,8,10,0,2,5,12,43
2022,Matt Thomas,SG,27,CHI,23,0,282,37,86,.430,25,57,.439,12,29,.414,.576,9,13,.692,2,25,27,14,6,1,6,11,108
2022,Klay Thompson,SG,31,GSW,6,6,128,32,86,.372,13,43,.302,19,43,.442,.448,11,11,1.000,3,14,17,12,4,2,11,8,88
2022,Tristan Thompson,PF,30,SAC,30,3,455,76,151,.503,1,1,1.000,75,150,.500,.507,32,60,.533,72,89,161,18,11,12,29,52,185
2022,JT Thor,PF,19,CHO,12,0,116,9,28,.321,3,17,.176,6,11,.545,.375,7,10,.700,6,11,17,7,4,6,4,14,28
2022,Matisse Thybulle,SG,24,PHI,32,17,825,76,156,.487,23,80,.288,53,76,.697,.561,9,13,.692,16,62,78,34,59,36,23,73,184
2022,Killian Tillie,C,23,MEM,28,3,376,37,105,.352,22,67,.328,15,38,.395,.457,5,8,.625,19,32,51,17,22,13,9,44,101
2022,Xavier Tillman Sr.,PF,23,MEM,37,0,505,67,151,.444,6,34,.176,61,117,.521,.464,31,48,.646,46,68,114,40,41,14,26,49,171
2022,Isaiah Todd,PF,20,WAS,9,0,35,5,15,.333,4,10,.400,1,5,.200,.467,2,4,.500,2,7,9,1,2,2,1,1,16
2022,Obi Toppin,PF,23,NYK,43,2,674,124,236,.525,16,70,.229,108,166,.651,.559,57,74,.770,41,114,155,41,13,20,34,61,321
2022,Juan Toscano-Anderson,SF,28,GSW,45,4,698,81,165,.491,17,61,.279,64,104,.615,.542,29,49,.592,24,106,130,87,34,14,50,73,208
2022,Karl-Anthony Towns,C,26,MIN,39,39,1345,337,654,.515,86,213,.404,251,441,.569,.581,187,232,.806,108,249,357,143,43,47,134,146,947
2022,Gary Trent Jr.,SG,23,TOR,35,34,1180,209,504,.415,96,260,.369,113,244,.463,.510,52,63,.825,14,81,95,71,65,13,34,76,566
2022,P.J. Tucker,PF,36,MIA,41,40,1161,124,252,.492,56,122,.459,68,130,.523,.603,27,39,.692,65,163,228,90,32,11,39,92,331
2022,Rayjon Tucker,SG,24,DEN,3,0,29,1,2,.500,1,2,.500,0,0,,.750,3,4,.750,1,3,4,4,1,0,0,3,6
2022,Myles Turner,C,25,IND,42,42,1235,200,393,.509,61,183,.333,139,210,.662,.587,79,105,.752,65,232,297,44,28,118,54,119,540
2022,Jonas Valančiūnas,C,29,NOP,43,43,1359,303,576,.526,43,103,.417,260,473,.550,.563,140,171,.819,146,370,516,107,22,38,105,137,789
2022,Denzel Valentine,SG,28,TOT,24,0,222,25,66,.379,19,47,.404,6,19,.316,.523,0,0,,9,33,42,11,8,0,12,20,69
2022,Jarred Vanderbilt,PF,22,MIN,41,34,1058,118,201,.587,2,10,.200,116,191,.607,.592,41,63,.651,130,242,372,55,65,29,43,116,279
2022,Fred VanVleet,PG,27,TOR,41,41,1567,302,717,.421,160,407,.393,142,310,.458,.533,127,146,.870,34,159,193,285,71,21,107,101,891
2022,Devin Vassell,SF,21,SAS,39,6,976,171,386,.443,68,194,.351,103,192,.536,.531,31,41,.756,25,140,165,51,38,27,30,84,441
2022,Gabe Vincent,PG,25,MIA,38,14,857,123,284,.433,65,171,.380,58,113,.513,.548,30,38,.789,15,57,72,118,35,10,59,86,341
2022,Nikola Vučević,C,31,CHI,39,39,1296,268,617,.434,66,199,.332,202,418,.483,.488,43,58,.741,79,361,440,136,40,47,66,90,645
2022,Dean Wade,PF,25,CLE,33,17,625,59,137,.431,30,88,.341,29,49,.592,.540,12,20,.600,24,82,106,35,18,3,12,49,160
2022,Franz Wagner,SF,20,ORL,48,48,1556,280,618,.453,56,167,.335,224,451,.497,.498,122,144,.847,56,172,228,138,46,26,78,104,738
2022,Moritz Wagner,C,24,ORL,38,0,470,101,203,.498,38,108,.352,63,95,.663,.591,52,65,.800,17,74,91,39,10,10,28,72,292
2022,Ish Wainright,PF,27,PHO,20,0,133,13,39,.333,5,22,.227,8,17,.471,.397,2,4,.500,14,12,26,8,7,2,8,24,33
2022,Kemba Walker,PG,31,NYK,27,27,725,124,299,.415,62,158,.392,62,141,.440,.518,48,59,.814,11,79,90,94,22,5,38,33,358
2022,Lonnie Walker IV,SG,23,SAS,43,6,979,176,452,.389,63,211,.299,113,241,.469,.459,66,80,.825,8,106,114,100,27,13,44,59,481
2022,M.J. Walker,SG,23,PHO,2,0,8,0,4,.000,0,2,.000,0,2,.000,.000,0,0,,0,1,1,1,2,0,0,1,0
2022,Derrick Walton,PG,26,DET,3,3,108,6,26,.231,3,13,.231,3,13,.231,.288,4,4,1.000,2,8,10,21,7,4,11,8,19
2022,Brad Wanamaker,PG,32,TOT,23,2,320,28,77,.364,4,17,.235,24,60,.400,.390,23,25,.920,6,33,39,55,7,6,23,45,83
2022,Duane Washington Jr.,PG,21,IND,16,7,311,46,126,.365,24,67,.358,22,59,.373,.460,14,19,.737,1,22,23,28,7,1,17,15,130
2022,P.J. Washington,PF,23,CHO,30,3,736,104,233,.446,55,136,.404,49,97,.505,.564,34,47,.723,42,123,165,66,21,33,43,75,297
2022,Yuta Watanabe,SF,27,TOR,19,4,323,38,99,.384,19,55,.345,19,44,.432,.480,14,24,.583,13,51,64,15,7,10,13,26,109
2022,Tremont Waters,PG,24,TOT,3,0,50,4,14,.286,2,9,.222,2,5,.400,.357,0,0,,0,4,4,7,5,0,4,4,10
2022,Trendon Watford,SF,21,POR,20,0,191,26,53,.491,0,4,.000,26,49,.531,.491,15,23,.652,15,34,49,15,3,10,13,18,67
2022,Paul Watson,SF,27,OKC,9,3,156,12,35,.343,6,26,.231,6,9,.667,.429,1,2,.500,3,24,27,8,3,3,4,10,31
2022,Quinndary Weatherspoon,SG,25,GSW,3,0,16,4,4,1.000,0,0,,4,4,1.000,1.000,0,0,,0,1,1,0,1,1,1,5,8
2022,Russell Westbrook,PG,33,LAL,47,47,1638,331,758,.437,48,162,.296,283,596,.475,.468,165,245,.673,67,312,379,367,52,12,194,147,875
2022,Coby White,PG,21,CHI,28,11,762,129,296,.436,54,154,.351,75,142,.528,.527,43,53,.811,8,74,82,73,16,8,37,64,355
2022,Derrick White,SG,27,SAS,42,41,1278,210,503,.417,66,221,.299,144,282,.511,.483,120,140,.857,24,126,150,235,46,39,71,95,606
2022,Hassan Whiteside,C,32,UTA,37,4,622,121,196,.617,0,0,,121,196,.617,.617,63,93,.677,84,171,255,14,10,49,34,105,305
2022,Joe Wieskamp,SG,22,SAS,13,0,77,11,23,.478,7,17,.412,4,6,.667,.630,3,7,.429,2,5,7,4,2,2,0,5,32
2022,Aaron Wiggins,SG,23,OKC,29,16,627,80,163,.491,23,73,.315,57,90,.633,.561,31,45,.689,24,73,97,30,23,6,26,56,214
2022,Andrew Wiggins,SF,26,GSW,43,43,1357,293,608,.482,94,230,.409,199,378,.526,.559,101,151,.669,46,134,180,86,40,26,67,80,781
2022,Lindell Wigginton,PG,23,MIL,1,0,5,1,1,1.000,0,0,,1,1,1.000,1.000,0,0,,0,1,1,0,1,0,0,0,2
2022,Brandon Williams,PG,22,POR,2,0,12,2,3,.667,0,0,,2,3,.667,.667,4,7,.571,0,2,2,2,0,0,0,0,8
2022,Grant Williams,PF,23,BOS,43,13,981,104,215,.484,63,147,.429,41,68,.603,.630,40,45,.889,31,111,142,44,21,28,33,91,311
2022,Kenrich Williams,SF,27,OKC,39,0,813,110,242,.455,34,89,.382,76,153,.497,.525,23,43,.535,57,104,161,75,36,5,33,64,277
2022,Lou Williams,PG,35,ATL,32,0,459,77,201,.383,21,68,.309,56,133,.421,.435,41,47,.872,10,40,50,55,17,2,26,32,216
2022,Patrick Williams,PF,20,CHI,5,5,125,13,23,.565,3,6,.500,10,17,.588,.630,4,4,1.000,1,10,11,3,3,2,2,9,33
2022,Robert Williams,C,24,BOS,37,37,1092,160,217,.737,0,0,,160,217,.737,.737,42,61,.689,143,198,341,70,30,78,47,80,362
2022,Ziaire Williams,SF,20,MEM,30,9,608,76,191,.398,30,114,.263,46,77,.597,.476,15,18,.833,8,39,47,24,15,7,16,57,197
2022,D.J. Wilson,PF,25,TOR,3,1,48,8,11,.727,0,2,.000,8,9,.889,.727,8,10,.800,1,13,14,4,5,1,2,5,24
2022,Dylan Windler,SF,25,CLE,32,0,335,33,74,.446,21,53,.396,12,21,.571,.588,7,9,.778,12,48,60,25,8,2,13,36,94
2022,Justise Winslow,SF,25,LAC,32,1,366,51,113,.451,5,24,.208,46,89,.517,.473,13,25,.520,19,81,100,37,17,13,28,35,120
2022,Cassius Winston,PG,23,WAS,2,0,7,0,2,.000,0,2,.000,0,0,,.000,2,2,1.000,0,0,0,2,0,0,1,0,2
2022,Christian Wood,C,26,HOU,44,43,1357,283,588,.481,77,211,.365,206,377,.546,.547,127,204,.623,76,377,453,95,34,41,79,104,770
2022,Robert Woodard II,SF,22,SAC,8,0,15,1,4,.250,1,1,1.000,0,3,.000,.375,2,2,1.000,0,2,2,0,0,0,1,2,5
2022,Delon Wright,SG,29,ATL,41,4,733,64,142,.451,25,58,.431,39,84,.464,.539,29,36,.806,29,86,115,105,38,8,29,29,182
2022,McKinley Wright IV,PG,23,MIN,3,0,9,2,3,.667,1,2,.500,1,1,1.000,.833,0,0,,0,0,0,1,0,0,1,1,5
2022,Moses Wright,PF,23,LAC,1,0,1,0,0,,0,0,,0,0,,,0,0,,0,0,0,1,0,0,0,0,0
2022,Thaddeus Young,PF,33,SAS,24,0,334,65,116,.560,0,3,.000,65,113,.575,.560,9,20,.450,34,48,82,55,20,7,26,34,139
2022,Trae Young,PG,23,ATL,42,42,1461,391,860,.455,123,324,.380,268,536,.500,.526,269,299,.900,27,139,166,390,41,4,174,69,1174
2022,Omer Yurtseven,C,23,MIA,36,10,545,98,188,.521,1,7,.143,97,181,.536,.524,32,50,.640,66,165,231,41,15,18,34,66,229
2022,Cody Zeller,C,29,POR,27,0,355,51,90,.567,0,4,.000,51,86,.593,.567,38,49,.776,50,75,125,22,8,6,19,56,140
2022,Ivica Zubac,C,24,LAC,44,44,1087,169,251,.673,0,0,,169,251,.673,.673,99,133,.744,123,238,361,52,21,47,59,109,437
